a => a
af => à
aj => ạ
ar => ả
as => á
aw => ă
awf => ằ
awj => ặ
awr => ẳ
aws => ắ
ax => ã
az => â
azf => ầ
azj => ậ
azr => ẩ
azs => ấ
azx => ẫ
acj => ạc
acs => ác
acwj => ặc
acws => ắc
aczj => ậc
aczs => ấc
achj => ạch
achs => ách
achwj => ặch
achws => ắch
ai => ai
aif => ài
aij => ại
air => ải
ais => ái
aix => ãi
am => am
amf => àm
amj => ạm
amr => ảm
ams => ám
amw => ăm
amwf => ằm
amwj => ặm
amwr => ẳm
amws => ắm
amwx => ẵm
amz => âm
amzf => ầm
amzj => ậm
amzr => ẩm
amzs => ấm
amzx => ẫm
an => an
anf => àn
anj => ạn
anr => ản
ans => án
anw => ăn
anwf => ằn
anwj => ặn
anwr => ẳn
anws => ắn
anwx => ẵn
anx => ãn
anz => ân
anzf => ần
anzj => ận
anzr => ẩn
anzs => ấn
anzx => ẫn
ang => ang
angf => àng
angj => ạng
angr => ảng
angs => áng
angw => ăng
angwf => ằng
angwj => ặng
angwr => ẳng
angws => ắng
angx => ãng
angz => âng
angzf => ầng
angzj => ậng
anh => anh
anhf => ành
anhj => ạnh
anhr => ảnh
anhs => ánh
anhw => ănh
anhws => ắnh
anhx => ãnh
anhz => ânh
anhzr => ẩnh
anhzs => ấnh
ao => ao
aof => ào
aoj => ạo
aor => ảo
aos => áo
aox => ão
aoz => aô
aozs => áô
apj => ạp
aps => áp
apwj => ặp
apws => ắp
apzj => ập
apzs => ấp
atj => ạt
ats => át
atwj => ặt
atws => ắt
atzj => ật
atzs => ất
au => au
auf => àu
aur => ảu
aus => áu
auz => âu
auzf => ầu
auzj => ậu
auzr => ẩu
auzs => ấu
auzx => ẫu
ay => ay
ayf => ày
ayj => ạy
ayr => ảy
ays => áy
ayx => ãy
ayz => ây
ayzf => ầy
ayzj => ậy
ayzr => ẩy
ayzs => ấy
ayzx => ẫy
ba => ba
baf => bà
baj => bạ
bar => bả
bas => bá
baw => bă
bawf => bằ
bawj => bặ
baws => bắ
bax => bã
baz => bâ
bazf => bầ
bazr => bẩ
bazs => bấ
bacj => bạc
bacs => bác
bacwj => bặc
bacws => bắc
baczj => bậc
baczs => bấc
bachj => bạch
bachs => bách
bachwj => bặch
bai => bai
baif => bài
baij => bại
bair => bải
bais => bái
baix => bãi
bam => bam
bamf => bàm
bamj => bạm
bamr => bảm
bams => bám
bamw => băm
bamwf => bằm
bamwj => bặm
bamwr => bẳm
bamws => bắm
bamwx => bẵm
bamz => bâm
bamzf => bầm
bamzj => bậm
bamzr => bẩm
bamzs => bấm
bamzx => bẫm
ban => ban
banf => bàn
banj => bạn
banr => bản
bans => bán
banw => băn
banwf => bằn
banwj => bặn
banwr => bẳn
banws => bắn
banx => bãn
banz => bân
banzf => bần
banzj => bận
banzr => bẩn
banzs => bấn
banzx => bẫn
bang => bang
bangf => bàng
bangj => bạng
bangr => bảng
bangs => báng
bangw => băng
bangwf => bằng
bangwj => bặng
bangwr => bẳng
bangws => bắng
bangwx => bẵng
bangx => bãng
bangz => bâng
bangzf => bầng
bangzj => bậng
bangzr => bẩng
bangzs => bấng
bangzx => bẫng
banh => banh
banhf => bành
banhj => bạnh
banhr => bảnh
banhs => bánh
banhwf => bằnh
banhx => bãnh
banhzj => bậnh
bao => bao
baof => bào
baoj => bạo
baor => bảo
baos => báo
baox => bão
bapj => bạp
baps => báp
bapwj => bặp
bapws => bắp
bapzj => bập
bapzs => bấp
batj => bạt
bats => bát
batwj => bặt
batws => bắt
batzj => bật
batzs => bất
bau => bau
bauf => bàu
bauj => bạu
baur => bảu
baus => báu
bauz => bâu
bauzf => bầu
bauzj => bậu
bauzr => bẩu
bauzs => bấu
bauzx => bẫu
bay => bay
bayf => bày
bayj => bạy
bayr => bảy
bays => báy
bayx => bãy
bayz => bây
bayzf => bầy
bayzj => bậy
bayzr => bẩy
bayzs => bấy
bayzx => bẫy
be => be
bef => bè
bej => bẹ
ber => bẻ
bes => bé
bex => bẽ
bez => bê
bezf => bề
bezj => bệ
bezr => bể
bezs => bế
bezx => bễ
becj => bẹc
becs => béc
beczs => bếc
bechzj => bệch
bechzs => bếch
bem => bem
bemf => bèm
bemr => bẻm
bems => bém
bemx => bẽm
bemzs => bếm
ben => ben
benf => bèn
benj => bẹn
benr => bẻn
bens => bén
benx => bẽn
benz => bên
benzf => bền
benzj => bện
benzr => bển
benzs => bến
benzx => bễn
beng => beng
bengf => bèng
bengs => béng
bengzj => bệng
benh => benh
benhj => bẹnh
benhs => bénh
benhz => bênh
benhzf => bềnh
benhzj => bệnh
benhzs => bếnh
benhzx => bễnh
beo => beo
beof => bèo
beoj => bẹo
beor => bẻo
beos => béo
beox => bẽo
bepj => bẹp
beps => bép
bepzj => bệp
bepzs => bếp
betj => bẹt
bets => bét
betzj => bệt
betzs => bết
beuz => bêu
beuzf => bều
beuzj => bệu
beuzr => bểu
beuzs => bếu
beuzx => bễu
bi => bi
bif => bì
bij => bị
bir => bỉ
bis => bí
bix => bĩ
bia => bia
biaf => bìa
biaj => bịa
bias => bía
bicj => bịc
bics => bíc
bichj => bịch
bichs => bích
bieczj => biệc
bieczs => biếc
biemz => biêm
biemzf => biềm
biemzj => biệm
biemzr => biểm
biemzs => biếm
bienz => biên
bienzf => biền
bienzj => biện
bienzr => biển
bienzs => biến
bienzx => biễn
biengz => biêng
biengzf => biềng
biengzr => biểng
biengzs => biếng
bienhzj => biệnh
biepzj => biệp
biepzs => biếp
bietzj => biệt
bietzs => biết
bieuz => biêu
bieuzf => biều
bieuzj => biệu
bieuzr => biểu
bieuzs => biếu
bieuzx => biễu
bim => bim
bimf => bìm
bimr => bỉm
bims => bím
bimx => bĩm
bin => bin
binf => bìn
binj => bịn
bins => bín
bing => bing
binh => binh
binhf => bình
binhj => bịnh
binhr => bỉnh
binhs => bính
binhx => bĩnh
bipj => bịp
bips => bíp
bitj => bịt
bits => bít
biu => biu
biuf => bìu
biuj => bịu
biur => bỉu
bius => bíu
biux => bĩu
bo => bo
bof => bò
boj => bọ
bor => bỏ
bos => bó
bow => bơ
bowf => bờ
bowj => bợ
bowr => bở
bows => bớ
bowx => bỡ
box => bõ
boz => bô
bozf => bồ
bozj => bộ
bozr => bổ
bozs => bố
bozx => bỗ
boa => boa
boar => bỏa
boacj => boạc
boacwj => boặc
boan => boan
boanw => boăn
boangf => boàng
boangr => boảng
boao => boao
bocj => bọc
bocs => bóc
bocws => bớc
boczj => bộc
boczs => bốc
bochzs => bốch
boe => boe
boes => bóe
boem => boem
boeng => boeng
boi => boi
boif => bòi
boij => bọi
boir => bỏi
bois => bói
boiw => bơi
boiwf => bời
boiwj => bợi
boiwr => bởi
boiws => bới
boiwx => bỡi
boiz => bôi
boizf => bồi
boizj => bội
boizr => bổi
boizs => bối
boizx => bỗi
bom => bom
bomf => bòm
bomj => bọm
bomr => bỏm
boms => bóm
bomw => bơm
bomwf => bờm
bomwj => bợm
bomws => bớm
bomx => bõm
bomz => bôm
bomzf => bồm
bomzj => bộm
bomzs => bốm
bomzx => bỗm
bon => bon
bonf => bòn
bonj => bọn
bonr => bỏn
bons => bón
bonw => bơn
bonwf => bờn
bonwj => bợn
bonwx => bỡn
bonz => bôn
bonzf => bồn
bonzj => bộn
bonzr => bổn
bonzs => bốn
bonzx => bỗn
bong => bong
bongf => bòng
bongj => bọng
bongr => bỏng
bongs => bóng
bongwf => bờng
bongx => bõng
bongz => bông
bongzf => bồng
bongzj => bộng
bongzr => bổng
bongzs => bống
bongzx => bỗng
boo => boo
boocj => boọc
boocs => boóc
boom => boom
boon => boon
boong => boong
boongf => boòng
boongr => boỏng
boongs => boóng
bopj => bọp
bops => bóp
bopwj => bợp
bopws => bớp
bopzj => bộp
bopzs => bốp
botj => bọt
bots => bót
botwj => bợt
botws => bớt
botzj => bột
botzs => bốt
bu => bu
buf => bù
buj => bụ
bur => bủ
bus => bú
buw => bư
buwf => bừ
buwj => bự
buws => bứ
buwx => bữ
bux => bũ
bua => bua
buaf => bùa
buaj => bụa
buar => bủa
buas => búa
buaw => bưa
buawf => bừa
buawj => bựa
buawr => bửa
buaws => bứa
buawx => bữa
buax => bũa
buanz => buân
buangz => buâng
bucj => bục
bucs => búc
bucwj => bực
bucws => bức
buchws => bứch
buez => buê
buezr => buể
buetzs => buết
bui => bui
buif => bùi
buij => bụi
buir => bủi
buis => búi
buiwr => bửi
buix => bũi
bum => bum
bumf => bùm
bumj => bụm
bumr => bủm
bums => búm
bun => bun
bunf => bùn
bunj => bụn
bunr => bủn
buns => bún
bunw => bưn
bunwf => bừn
bunwr => bửn
bung => bung
bungf => bùng
bungj => bụng
bungr => bủng
bungs => búng
bungw => bưng
bungwf => bừng
bungwj => bựng
bungwr => bửng
bungws => bứng
bungwx => bững
bunhf => bùnh
buows => bướ
buocwj => bược
buocws => bước
buoczj => buộc
buoczs => buốc
buoi => buoi
buoiw => bươi
buoiwf => bười
buoiwj => bượi
buoiwr => bưởi
buoiws => bưới
buoiz => buôi
buoizf => buồi
buoizj => buội
buoizr => buổi
buoizs => buối
buoizx => buỗi
buom => buom
buomw => bươm
buomwf => bườm
buomwj => bượm
buomws => bướm
buomz => buôm
buomzf => buồm
buomzj => buộm
buon => buon
buonw => bươn
buonwf => bườn
buonws => bướn
buonz => buôn
buonzf => buồn
buonzj => buộn
buonzr => buổn
buonzs => buốn
buonzx => buỗn
buong => buong
buongw => bương
buongwf => bường
buongwr => bưởng
buongws => bướng
buongz => buông
buongzf => buồng
buongzr => buổng
buongzs => buống
buopws => bướp
buotwj => bượt
buotws => bướt
buotzj => buột
buotzs => buốt
buouw => bươu
buouwr => bưởu
buouws => bướu
buoy => buoy
bupj => bụp
bups => búp
butj => bụt
buts => bút
butwj => bựt
butws => bứt
buuw => bưu
buuwf => bừu
buuwr => bửu
buuws => bứu
buuwx => bữu
buy => buy
buyr => bủy
buys => búy
buyng => buyng
buyps => buýp
buyts => buýt
by => by
byf => bỳ
byj => bỵ
bys => bý
ca => ca
caf => cà
caj => cạ
car => cả
cas => cá
caw => că
cawj => cặ
caws => cắ
cax => cã
caz => câ
cazf => cầ
cazj => cậ
cazr => cẩ
cazs => cấ
cacj => cạc
cacs => các
cacwj => cặc
cacws => cắc
caczj => cậc
caczs => cấc
cachj => cạch
cachs => cách
cai => cai
caif => cài
caij => cại
cair => cải
cais => cái
caix => cãi
caizf => cầi
cam => cam
camf => càm
camj => cạm
camr => cảm
cams => cám
camw => căm
camwf => cằm
camwj => cặm
camwr => cẳm
camws => cắm
camx => cãm
camz => câm
camzf => cầm
camzj => cậm
camzr => cẩm
camzs => cấm
can => can
canf => càn
canj => cạn
canr => cản
cans => cán
canw => căn
canwf => cằn
canwj => cặn
canwr => cẳn
canws => cắn
canwx => cẵn
canx => cãn
canz => cân
canzf => cần
canzj => cận
canzr => cẩn
canzs => cấn
canzx => cẫn
cang => cang
cangf => càng
cangj => cạng
cangr => cảng
cangs => cáng
cangw => căng
cangwf => cằng
cangwr => cẳng
cangws => cắng
cangwx => cẵng
cangx => cãng
cangz => câng
cangzf => cầng
cangzj => cậng
cangzr => cẩng
cangzx => cẫng
canh => canh
canhf => cành
canhj => cạnh
canhr => cảnh
canhs => cánh
canhx => cãnh
canhzj => cậnh
cao => cao
caof => cào
caoj => cạo
caor => cảo
caos => cáo
caox => cão
caoz => caô
caozs => cáô
capj => cạp
caps => cáp
capwj => cặp
capws => cắp
capzj => cập
capzs => cấp
catj => cạt
cats => cát
catwj => cặt
catws => cắt
catzj => cật
catzs => cất
cau => cau
cauf => càu
cauj => cạu
caur => cảu
caus => cáu
cauz => câu
cauzf => cầu
cauzj => cậu
cauzr => cẩu
cauzs => cấu
cauzx => cẫu
cay => cay
cayf => cày
cayj => cạy
cayr => cảy
cays => cáy
cayx => cãy
cayz => cây
cayzf => cầy
cayzj => cậy
cayzs => cấy
ce => ce
ces => cé
cex => cẽ
cez => cê
cezf => cề
cezj => cệ
cecj => cẹc
cem => cem
cen => cen
ceng => ceng
cengz => cêng
cenhzf => cềnh
ceo => ceo
cha => cha
chaf => chà
chaj => chạ
char => chả
chas => chá
chaw => chă
chawj => chặ
chaws => chắ
chawx => chẵ
chax => chã
chaz => châ
chazs => chấ
chacj => chạc
chacs => chác
chacwj => chặc
chacws => chắc
chaczj => chậc
chaczs => chấc
chachj => chạch
chachs => chách
chai => chai
chaif => chài
chaij => chại
chair => chải
chais => chái
chaix => chãi
cham => cham
chamf => chàm
chamj => chạm
chamr => chảm
chams => chám
chamw => chăm
chamwf => chằm
chamwj => chặm
chamwr => chẳm
chamws => chắm
chamx => chãm
chamz => châm
chamzf => chầm
chamzj => chậm
chamzr => chẩm
chamzs => chấm
chamzx => chẫm
chan => chan
chanf => chàn
chanj => chạn
chanr => chản
chans => chán
chanw => chăn
chanwf => chằn
chanwj => chặn
chanwr => chẳn
chanws => chắn
chanwx => chẵn
chanz => chân
chanzf => chần
chanzj => chận
chanzr => chẩn
chanzs => chấn
chanzx => chẫn
chang => chang
changf => chàng
changj => chạng
changr => chảng
changs => cháng
changw => chăng
changwf => chằng
changwj => chặng
changwr => chẳng
changws => chắng
changwx => chẵng
changz => châng
changzf => chầng
changzr => chẩng
changzs => chấng
chanh => chanh
chanhf => chành
chanhj => chạnh
chanhr => chảnh
chanhs => chánh
chao => chao
chaof => chào
chaoj => chạo
chaor => chảo
chaos => cháo
chaox => chão
chaozs => cháô
chapj => chạp
chaps => cháp
chapwj => chặp
chapws => chắp
chapzj => chập
chapzs => chấp
chatj => chạt
chats => chát
chatwj => chặt
chatws => chắt
chatzj => chật
chatzs => chất
chau => chau
chauf => chàu
chaur => chảu
chaus => cháu
chaux => chãu
chauz => châu
chauzf => chầu
chauzj => chậu
chauzr => chẩu
chauzs => chấu
chauzx => chẫu
chay => chay
chayf => chày
chayj => chạy
chayr => chảy
chays => cháy
chayz => chây
chayzf => chầy
chayzj => chậy
chayzr => chẩy
chayzs => chấy
che => che
chef => chè
chej => chẹ
cher => chẻ
ches => ché
chex => chẽ
chez => chê
chezf => chề
chezj => chệ
chezr => chể
chezs => chế
chezx => chễ
checj => chẹc
checs => chéc
checzj => chệc
checzs => chếc
chechzj => chệch
chechzs => chếch
chem => chem
chemf => chèm
chemj => chẹm
chemr => chẻm
chems => chém
chemx => chẽm
chemz => chêm
chemzs => chếm
chemzx => chễm
chen => chen
chenf => chèn
chenj => chẹn
chenr => chẻn
chens => chén
chenx => chẽn
chenz => chên
chenzj => chện
chenzs => chến
cheng => cheng
chengf => chèng
chengj => chẹng
chengs => chéng
chengz => chêng
chenhz => chênh
chenhzf => chềnh
chenhzj => chệnh
chenhzr => chểnh
chenhzs => chếnh
cheo => cheo
cheof => chèo
cheoj => chẹo
cheor => chẻo
cheos => chéo
chepj => chẹp
cheps => chép
chepzs => chếp
chetj => chẹt
chets => chét
chetzj => chệt
chetzs => chết
cheuz => chêu
cheuzf => chều
cheuzs => chếu
chi => chi
chif => chì
chij => chị
chir => chỉ
chis => chí
chix => chĩ
chia => chia
chiaf => chìa
chiaj => chịa
chiar => chỉa
chias => chía
chiax => chĩa
chics => chíc
chichj => chịch
chichs => chích
chieczj => chiệc
chieczs => chiếc
chiemz => chiêm
chiemzf => chiềm
chiemzj => chiệm
chiemzr => chiểm
chiemzs => chiếm
chiemzx => chiễm
chienz => chiên
chienzf => chiền
chienzj => chiện
chienzr => chiển
chienzs => chiến
chienzx => chiễn
chiengz => chiêng
chiengzf => chiềng
chiengzj => chiệng
chiengzs => chiếng
chiepzs => chiếp
chietzs => chiết
chieuz => chiêu
chieuzf => chiều
chieuzj => chiệu
chieuzr => chiểu
chieuzs => chiếu
chim => chim
chimf => chìm
chimj => chịm
chimr => chỉm
chims => chím
chin => chin
chinf => chìn
chinj => chịn
chinr => chỉn
chins => chín
ching => ching
chings => chíng
chinh => chinh
chinhf => chình
chinhj => chịnh
chinhr => chỉnh
chinhs => chính
chinhx => chĩnh
chipj => chịp
chips => chíp
chitj => chịt
chits => chít
chiu => chiu
chiuf => chìu
chiuj => chịu
chius => chíu
chiux => chĩu
cho => cho
chof => chò
choj => chọ
chor => chỏ
chos => chó
chow => chơ
chowf => chờ
chowj => chợ
chowr => chở
chows => chớ
chowx => chỡ
chox => chõ
choz => chô
chozf => chồ
chozj => chộ
chozr => chổ
chozs => chố
chozx => chỗ
choa => choa
choas => chóa
choaw => choă
choax => chõa
choacj => choạc
choacs => choác
choacwj => choặc
choacws => choắc
choachj => choạch
choachs => choách
choai => choai
choaif => choài
choaij => choại
choair => choải
choais => choái
choaix => choãi
choamf => choàm
choan => choan
choanf => choàn
choans => choán
choanw => choăn
choanwf => choằn
choang => choang
choangf => choàng
choangj => choạng
choangr => choảng
choangs => choáng
choangw => choăng
choangwr => choẳng
choanh => choanh
choanhf => choành
choanhr => choảnh
choanhs => choánh
choapj => choạp
choatws => choắt
choay => choay
chocj => chọc
chocs => chóc
choczs => chốc
choe => choe
choef => chòe
choej => chọe
choes => chóe
choem => choem
choen => choen
choenf => choèn
choeng => choeng
choetj => choẹt
choets => choét
choi => choi
choif => chòi
choij => chọi
choir => chỏi
chois => chói
choiw => chơi
choiwf => chời
choiwj => chợi
choiwr => chởi
choiws => chới
choix => chõi
choiz => chôi
choizf => chồi
choizj => chội
choizr => chổi
choizs => chối
choizx => chỗi
chom => chom
chomf => chòm
chomr => chỏm
choms => chóm
chomw => chơm
chomwf => chờm
chomwj => chợm
chomwr => chởm
chomws => chớm
chomx => chõm
chomz => chôm
chomzf => chồm
chomzj => chộm
chomzr => chổm
chomzx => chỗm
chon => chon
chonf => chòn
chonj => chọn
chonr => chỏn
chons => chón
chonw => chơn
chonwf => chờn
chonwj => chợn
chonws => chớn
chonx => chõn
chonz => chôn
chonzf => chồn
chonzj => chộn
chonzr => chổn
chonzs => chốn
chong => chong
chongf => chòng
chongj => chọng
chongr => chỏng
chongs => chóng
chongw => chơng
chongwf => chờng
chongws => chớng
chongx => chõng
chongz => chông
chongzf => chồng
chongzj => chộng
chongzr => chổng
chongzs => chống
chongzx => chỗng
chonh => chonh
chonhzf => chồnh
choo => choo
chooj => chọo
choox => chõo
choocs => choóc
choom => choom
choon => choon
choong => choong
choongf => choòng
choongj => choọng
choongr => choỏng
choongs => choóng
chopj => chọp
chops => chóp
chopwj => chợp
chopws => chớp
chopzj => chộp
chopzs => chốp
chotj => chọt
chots => chót
chotwj => chợt
chotws => chớt
chotzj => chột
chotzs => chốt
chu => chu
chuf => chù
chuj => chụ
chur => chủ
chus => chú
chuw => chư
chuwf => chừ
chuwj => chự
chuwr => chử
chuws => chứ
chuwx => chữ
chux => chũ
chua => chua
chuaf => chùa
chuaj => chụa
chuar => chủa
chuas => chúa
chuaw => chưa
chuawf => chừa
chuawj => chựa
chuawr => chửa
chuaws => chứa
chuawx => chữa
chuax => chũa
chuazr => chủâ
chuamzr => chuẩm
chuanz => chuân
chuanzf => chuần
chuanzj => chuận
chuanzr => chuẩn
chuanzs => chuấn
chuanzx => chuẫn
chuatzj => chuật
chuatzs => chuất
chucj => chục
chucs => chúc
chucwj => chực
chucws => chức
chuez => chuê
chuezr => chuể
chuezs => chuế
chueczs => chuếc
chuechzj => chuệch
chuechzs => chuếch
chuenz => chuên
chuenzj => chuện
chuenzr => chuển
chuenhzf => chuềnh
chuenhzj => chuệnh
chuenhzs => chuếnh
chui => chui
chuif => chùi
chuij => chụi
chuir => chủi
chuis => chúi
chuiwr => chửi
chuiwx => chữi
chuix => chũi
chum => chum
chumf => chùm
chumj => chụm
chumr => chủm
chums => chúm
chumx => chũm
chun => chun
chunf => chùn
chunj => chụn
chunr => chủn
chuns => chún
chunw => chưn
chunwf => chừn
chunwr => chửn
chunws => chứn
chunx => chũn
chung => chung
chungf => chùng
chungj => chụng
chungr => chủng
chungs => chúng
chungw => chưng
chungwf => chừng
chungwj => chựng
chungwr => chửng
chungws => chứng
chungwx => chững
chungx => chũng
chunhs => chúnh
chunhws => chứnh
chuo => chuo
chuowj => chượ
chuowr => chưở
chuocwj => chược
chuocws => chước
chuoczj => chuộc
chuoczs => chuốc
chuoi => chuoi
chuoiw => chươi
chuoiwr => chưởi
chuoiz => chuôi
chuoizf => chuồi
chuoizj => chuội
chuoizr => chuổi
chuoizs => chuối
chuoizx => chuỗi
chuomwf => chườm
chuomz => chuôm
chuomzf => chuồm
chuomzj => chuộm
chuomzr => chuổm
chuon => chuon
chuonwf => chườn
chuonwj => chượn
chuonz => chuôn
chuonzf => chuồn
chuonzj => chuộn
chuong => chuong
chuongw => chương
chuongwf => chường
chuongwj => chượng
chuongwr => chưởng
chuongws => chướng
chuongwx => chưỡng
chuongz => chuông
chuongzf => chuồng
chuongzj => chuộng
chuongzr => chuổng
chuongzs => chuống
chuopwj => chượp
chuopzs => chuốp
chuotws => chướt
chuotzj => chuột
chuotzs => chuốt
chupj => chụp
chups => chúp
chutj => chụt
chuts => chút
chutws => chứt
chuuwr => chửu
chuuws => chứu
chuuwx => chữu
chuy => chuy
chuyf => chùy
chuyj => chụy
chuyr => chủy
chuys => chúy
chuya => chuya
chuyas => chuýa
chuyeczs => chuyếc
chuyechzj => chuyệch
chuyemz => chuyêm
chuyenz => chuyên
chuyenzf => chuyền
chuyenzj => chuyện
chuyenzr => chuyển
chuyenzs => chuyến
chuyenzx => chuyễn
chuyenhzs => chuyếnh
chuyepzj => chuyệp
chuyetzj => chuyệt
chuyetzs => chuyết
chuyn => chuyn
chyr => chỷ
chys => chý
ci => ci
cif => cì
cij => cị
cir => cỉ
cis => cí
cix => cĩ
cia => cia
ciar => cỉa
cieczj => ciệc
cieczs => ciếc
cienz => ciên
cienzj => ciện
cienzs => ciến
cieuzf => ciều
cim => cim
cimf => cìm
cin => cin
cinf => cìn
cins => cín
cing => cing
cingf => cìng
cingx => cĩng
cinh => cinh
cinhr => cỉnh
cinhs => cính
cits => cít
ciu => ciu
co => co
cof => cò
coj => cọ
cor => cỏ
cos => có
cow => cơ
cowf => cờ
cowj => cợ
cowr => cở
cows => cớ
cowx => cỡ
cox => cõ
coz => cô
cozf => cồ
cozj => cộ
cozr => cổ
cozs => cố
cozx => cỗ
coa => coa
coar => cỏa
coas => cóa
coais => coái
coamws => coắm
coan => coan
coangs => coáng
cocj => cọc
cocs => cóc
coczj => cộc
coczs => cốc
coe => coe
coem => coem
coen => coen
coi => coi
coif => còi
coij => cọi
coir => cỏi
cois => cói
coiw => cơi
coiwf => cời
coiwj => cợi
coiwr => cởi
coiws => cới
coiwx => cỡi
coix => cõi
coiz => côi
coizf => cồi
coizj => cội
coizr => cổi
coizs => cối
coizx => cỗi
com => com
comf => còm
comj => cọm
comr => cỏm
coms => cóm
comw => cơm
comwf => cờm
comwj => cợm
comwr => cởm
comws => cớm
comwx => cỡm
comx => cõm
comz => côm
comzf => cồm
comzj => cộm
comzr => cổm
comzs => cốm
comzx => cỗm
con => con
conf => còn
conj => cọn
conr => cỏn
cons => cón
conw => cơn
conwf => cờn
conwj => cợn
conwr => cởn
conws => cớn
conwx => cỡn
conz => côn
conzf => cồn
conzj => cộn
conzr => cổn
conzs => cốn
cong => cong
congf => còng
congj => cọng
congr => cỏng
congs => cóng
congx => cõng
congz => công
congzf => cồng
congzj => cộng
congzr => cổng
congzs => cống
congzx => cỗng
conhw => cơnh
conhz => cônh
conhzr => cổnh
coo => coo
coos => cóo
coocj => coọc
coocs => coóc
cooms => coóm
coon => coon
coons => coón
coong => coong
coongf => coòng
coongj => coọng
coongr => coỏng
coongs => coóng
copj => cọp
cops => cóp
copwj => cợp
copws => cớp
copzj => cộp
copzs => cốp
cotj => cọt
cots => cót
cotwj => cợt
cotws => cớt
cotzj => cột
cotzs => cốt
cu => cu
cuf => cù
cuj => cụ
cur => củ
cus => cú
cuw => cư
cuwf => cừ
cuwj => cự
cuwr => cử
cuws => cứ
cuwx => cữ
cux => cũ
cua => cua
cuaf => cùa
cuaj => cụa
cuar => của
cuas => cúa
cuaw => cưa
cuawf => cừa
cuawj => cựa
cuawr => cửa
cuaws => cứa
cuawx => cữa
cuax => cũa
cuazr => củâ
cuanz => cuân
cuangz => cuâng
cuatzs => cuất
cucj => cục
cucs => cúc
cucwj => cực
cucws => cức
cui => cui
cuif => cùi
cuij => cụi
cuir => củi
cuis => cúi
cuiwf => cừi
cuiwr => cửi
cuiws => cứi
cuix => cũi
cum => cum
cumf => cùm
cumj => cụm
cumr => củm
cums => cúm
cumw => cưm
cun => cun
cunf => cùn
cunr => củn
cuns => cún
cunw => cưn
cunws => cứn
cunx => cũn
cung => cung
cungf => cùng
cungj => cụng
cungr => củng
cungs => cúng
cungw => cưng
cungwf => cừng
cungwj => cựng
cungwr => cửng
cungws => cứng
cungwx => cững
cungx => cũng
cunh => cunh
cuo => cuo
cuowf => cườ
cuows => cướ
cuocwj => cược
cuocws => cước
cuoczj => cuộc
cuoczs => cuốc
cuoi => cuoi
cuoiw => cươi
cuoiwf => cười
cuoiwr => cưởi
cuoiws => cưới
cuoiwx => cưỡi
cuoiz => cuôi
cuoizf => cuồi
cuoizj => cuội
cuoizr => cuổi
cuoizs => cuối
cuoizx => cuỗi
cuomw => cươm
cuomwf => cườm
cuomwj => cượm
cuomwr => cưởm
cuomws => cướm
cuomz => cuôm
cuomzf => cuồm
cuomzj => cuộm
cuomzr => cuổm
cuomzs => cuốm
cuomzx => cuỗm
cuon => cuon
cuonwf => cườn
cuonz => cuôn
cuonzf => cuồn
cuonzj => cuộn
cuonzr => cuổn
cuonzs => cuốn
cuonzx => cuỗn
cuong => cuong
cuongw => cương
cuongwf => cường
cuongwj => cượng
cuongwr => cưởng
cuongws => cướng
cuongwx => cưỡng
cuongz => cuông
cuongzf => cuồng
cuongzj => cuộng
cuongzr => cuổng
cuongzs => cuống
cuongzx => cuỗng
cuopws => cướp
cuopzj => cuộp
cuotzj => cuột
cuotzs => cuốt
cuou => cuou
cuouwf => cườu
cupj => cụp
cups => cúp
cupwj => cựp
cupws => cứp
cutj => cụt
cuts => cút
cutws => cứt
cuuw => cưu
cuuwf => cừu
cuuwj => cựu
cuuwr => cửu
cuuws => cứu
cuuwx => cữu
cuy => cuy
cuyenz => cuyên
cuyenzj => cuyện
cuyenzr => cuyển
cuyenzs => cuyến
cy => cy
cyf => cỳ
da => da
daf => dà
daj => dạ
dar => dả
das => dá
daw => dă
daws => dắ
dax => dã
daz => dâ
dazf => dầ
dazj => dậ
dazx => dẫ
dacj => dạc
dacs => dác
dacwj => dặc
dacws => dắc
dachj => dạch
dachs => dách
dai => dai
daif => dài
daij => dại
dair => dải
dais => dái
daix => dãi
daizf => dầi
dam => dam
damf => dàm
damj => dạm
damr => dảm
dams => dám
damw => dăm
damwf => dằm
damwj => dặm
damws => dắm
damwx => dẵm
damz => dâm
damzf => dầm
damzj => dậm
damzr => dẩm
damzs => dấm
damzx => dẫm
dan => dan
danf => dàn
danj => dạn
danr => dản
dans => dán
danw => dăn
danwf => dằn
danwj => dặn
danwr => dẳn
danws => dắn
danwx => dẵn
danx => dãn
danz => dân
danzf => dần
danzj => dận
danzr => dẩn
danzs => dấn
danzx => dẫn
dang => dang
dangf => dàng
dangj => dạng
dangr => dảng
dangs => dáng
dangw => dăng
dangwf => dằng
dangwj => dặng
dangwr => dẳng
dangws => dắng
dangwx => dẵng
dangx => dãng
dangz => dâng
dangzx => dẫng
danh => danh
danhf => dành
danhj => dạnh
danhr => dảnh
danhs => dánh
danhx => dãnh
danhz => dânh
dao => dao
daof => dào
daoj => dạo
daor => dảo
daos => dáo
daox => dão
daoz => daô
dapj => dạp
daps => dáp
dapwj => dặp
dapws => dắp
dapzj => dập
dapzs => dấp
datj => dạt
dats => dát
datwj => dặt
datws => dắt
datzj => dật
datzs => dất
dau => dau
dauf => dàu
dauj => dạu
daus => dáu
daux => dãu
dauz => dâu
dauzf => dầu
dauzj => dậu
dauzr => dẩu
dauzs => dấu
dauzx => dẫu
day => day
dayf => dày
dayj => dạy
dayr => dảy
days => dáy
dayx => dãy
dayz => dây
dayzf => dầy
dayzj => dậy
dayzr => dẩy
dayzs => dấy
dayzx => dẫy
dda => đa
ddaf => đà
ddaj => đạ
ddar => đả
ddas => đá
ddaw => đă
ddawf => đằ
ddawj => đặ
ddawr => đẳ
ddaws => đắ
ddawx => đẵ
ddax => đã
ddaz => đâ
ddazf => đầ
ddazj => đậ
ddazr => đẩ
ddazs => đấ
ddazx => đẫ
ddaaf => ddaaf
ddaax => ddaax
ddacj => đạc
ddacs => đác
ddacwj => đặc
ddacws => đắc
ddaczj => đậc
ddaczs => đấc
ddachj => đạch
ddachs => đách
ddai => đai
ddaif => đài
ddaij => đại
ddair => đải
ddais => đái
ddaix => đãi
ddaizf => đầi
ddaizj => đậi
ddaizs => đấi
ddam => đam
ddamf => đàm
ddamj => đạm
ddamr => đảm
ddams => đám
ddamw => đăm
ddamwf => đằm
ddamwj => đặm
ddamws => đắm
ddamwx => đẵm
ddamx => đãm
ddamz => đâm
ddamzf => đầm
ddamzj => đậm
ddamzr => đẩm
ddamzs => đấm
ddamzx => đẫm
ddan => đan
ddanf => đàn
ddanj => đạn
ddanr => đản
ddans => đán
ddanw => đăn
ddanwf => đằn
ddanwj => đặn
ddanws => đắn
ddanwx => đẵn
ddanx => đãn
ddanz => đân
ddanz => đân
ddanzf => đần
ddanzj => đận
ddanzr => đẩn
ddanzs => đấn
ddanzx => đẫn
ddang => đang
ddangf => đàng
ddangj => đạng
ddangr => đảng
ddangs => đáng
ddangw => đăng
ddangwf => đằng
ddangwj => đặng
ddangwr => đẳng
ddangws => đắng
ddangwx => đẵng
ddangx => đãng
ddangz => đâng
ddangzf => đầng
ddangzj => đậng
ddangzr => đẩng
ddangzs => đấng
ddanh => đanh
ddanhf => đành
ddanhj => đạnh
ddanhr => đảnh
ddanhs => đánh
ddanhs => đánh
ddanhw => đănh
ddanhx => đãnh
ddanhz => đânh
ddanhzs => đấnh
ddao => đao
ddaof => đào
ddaoj => đạo
ddaor => đảo
ddaos => đáo
ddaox => đão
ddaoz => đaô
ddaozf => đàô
ddaozj => đạô
ddaozs => đáô
ddapj => đạp
ddaps => đáp
ddapwj => đặp
ddapws => đắp
ddapzj => đập
ddapzs => đấp
ddatj => đạt
ddats => đát
ddatwj => đặt
ddatws => đắt
ddatzj => đật
ddatzs => đất
ddau => đau
ddauf => đàu
ddauj => đạu
ddaur => đảu
ddaus => đáu
ddauz => đâu
ddauzf => đầu
ddauzj => đậu
ddauzr => đẩu
ddauzs => đấu
ddauzx => đẫu
dday => đay
ddayf => đày
ddayj => đạy
ddayr => đảy
ddays => đáy
ddayx => đãy
ddayz => đây
ddayzf => đầy
ddayzj => đậy
ddayzj => đậy
ddayzr => đẩy
ddayzs => đấy
ddayzx => đẫy
dde => đe
ddef => đè
ddej => đẹ
dder => đẻ
ddes => đé
ddex => đẽ
ddez => đê
ddezf => đề
ddezj => đệ
ddezr => để
ddezs => đế
ddezx => đễ
ddecj => đẹc
ddecs => đéc
ddeczs => đếc
ddechzj => đệch
ddechzs => đếch
ddem => đem
ddemf => đèm
ddemj => đẹm
ddems => đém
ddemz => đêm
ddemzf => đềm
ddemzj => đệm
ddemzr => đểm
ddemzs => đếm
dden => đen
ddenf => đèn
ddenj => đẹn
ddenr => đẻn
ddens => đén
ddenx => đẽn
ddenz => đên
ddenz => đên
ddenzf => đền
ddenzj => đện
ddenzr => đển
ddenzs => đến
ddenzx => đễn
ddeng => đeng
ddengr => đẻng
ddengs => đéng
ddengz => đêng
ddengzf => đềng
ddengzs => đếng
ddenhz => đênh
ddenhzf => đềnh
ddenhzj => đệnh
ddenhzr => đểnh
ddenhzs => đếnh
ddenhzx => đễnh
ddeo => đeo
ddeof => đèo
ddeoj => đẹo
ddeor => đẻo
ddeos => đéo
ddeox => đẽo
ddepj => đẹp
ddeps => đép
ddepzj => đệp
ddepzs => đếp
ddetj => đẹt
ddets => đét
ddetzj => đệt
ddetzs => đết
ddeuz => đêu
ddeuzf => đều
ddeuzj => đệu
ddeuzr => đểu
ddeuzs => đếu
ddi => đi
ddif => đì
ddij => đị
ddir => đỉ
ddis => đí
ddix => đĩ
ddia => đia
ddiaf => đìa
ddiaj => địa
ddiar => đỉa
ddias => đía
ddiax => đĩa
ddicj => địc
ddics => đíc
ddichj => địch
ddichs => đích
ddieczs => điếc
ddiem => điem
ddiemr => điẻm
ddiemz => điêm
ddiemzf => điềm
ddiemzj => điệm
ddiemzr => điểm
ddiemzs => điếm
ddiemzx => điễm
ddienj => điẹn
ddienz => điên
ddienzf => điền
ddienzj => điện
ddienzr => điển
ddienzs => điến
ddienzx => điễn
ddiengz => điêng
ddiengzf => điềng
ddiengzj => điệng
ddiengzr => điểng
ddiengzs => điếng
ddiepzj => điệp
ddiepzs => điếp
ddietzj => điệt
ddietzs => điết
ddieu => đieu
ddieuf => đièu
ddieuz => điêu
ddieuzf => điều
ddieuzj => điệu
ddieuzr => điểu
ddieuzs => điếu
ddim => đim
ddin => đin
ddinf => đìn
ddinj => địn
ddins => đín
dding => đing
ddingf => đìng
ddingj => địng
ddings => đíng
ddinh => đinh
ddinhf => đình
ddinhj => định
ddinhr => đỉnh
ddinhs => đính
ddinhx => đĩnh
ddipj => địp
ddips => đíp
dditj => địt
ddits => đít
ddiu => điu
ddiuf => đìu
ddiuj => địu
ddiur => đỉu
ddius => đíu
ddiux => đĩu
ddo => đo
ddo => đo
ddof => đò
ddoj => đọ
ddor => đỏ
ddos => đó
ddow => đơ
ddowf => đờ
ddowj => đợ
ddowr => đở
ddows => đớ
ddowx => đỡ
ddox => đõ
ddoz => đô
ddoz => đô
ddozf => đồ
ddozf => đồ
ddozj => độ
ddozr => đổ
ddozs => đố
ddozx => đỗ
ddoa => đoa
ddoaf => đòa
ddoaj => đọa
ddoar => đỏa
ddoas => đóa
ddoax => đõa
ddoacs => đoác
ddoacwj => đoặc
ddoachj => đoạch
ddoai => đoai
ddoaif => đoài
ddoaij => đoại
ddoais => đoái
ddoamf => đoàm
ddoan => đoan
ddoanf => đoàn
ddoanj => đoạn
ddoanr => đoản
ddoans => đoán
ddoanx => đoãn
ddoang => đoang
ddoangf => đoàng
ddoangr => đoảng
ddoangs => đoáng
ddoangx => đoãng
ddoanh => đoanh
ddoanhf => đoành
ddoanhj => đoạnh
ddoanhr => đoảnh
ddoanhs => đoánh
ddoatj => đoạt
ddoats => đoát
ddocj => đọc
ddocs => đóc
ddocwj => đợc
ddocws => đớc
ddoczj => độc
ddoczs => đốc
ddochws => đớch
ddoef => đòe
ddoen => đoen
ddoi => đoi
ddoif => đòi
ddoij => đọi
ddoir => đỏi
ddois => đói
ddoiw => đơi
ddoiwf => đời
ddoiwj => đợi
ddoiwr => đởi
ddoiws => đới
ddoiwx => đỡi
ddoix => đõi
ddoiz => đôi
ddoizf => đồi
ddoizj => đội
ddoizr => đổi
ddoizs => đối
ddoizx => đỗi
ddom => đom
ddomf => đòm
ddomr => đỏm
ddoms => đóm
ddomw => đơm
ddomwf => đờm
ddomwj => đợm
ddomwr => đởm
ddomws => đớm
ddomx => đõm
ddomz => đôm
ddomzf => đồm
ddomzj => độm
ddomzr => đổm
ddomzs => đốm
ddon => đon
ddonf => đòn
ddonj => đọn
ddonr => đỏn
ddons => đón
ddonw => đơn
ddonwf => đờn
ddonwj => đợn
ddonwr => đởn
ddonws => đớn
ddonwx => đỡn
ddonx => đõn
ddonz => đôn
ddonzf => đồn
ddonzj => độn
ddonzr => đổn
ddonzs => đốn
ddonzx => đỗn
ddong => đong
ddongf => đòng
ddongj => đọng
ddongr => đỏng
ddongs => đóng
ddongw => đơng
ddongwf => đờng
ddongx => đõng
ddongz => đông
ddongzf => đồng
ddongzj => động
ddongzr => đổng
ddongzs => đống
ddongzx => đỗng
ddonhz => đônh
ddonhzj => độnh
ddooj => đọo
ddoocj => đoọc
ddoocs => đoóc
ddoong => đoong
ddoongf => đoòng
ddoongj => đoọng
ddoongr => đoỏng
ddoongs => đoóng
ddopj => đọp
ddops => đóp
ddopwj => đợp
ddopws => đớp
ddopzj => độp
ddopzs => đốp
ddotj => đọt
ddots => đót
ddotwj => đợt
ddotws => đớt
ddotzj => đột
ddotzs => đốt
ddu => đu
dduf => đù
dduj => đụ
ddur => đủ
ddus => đú
dduw => đư
dduwf => đừ
dduwj => đự
dduwr => đử
dduws => đứ
ddux => đũ
ddua => đua
dduaf => đùa
dduaj => đụa
dduar => đủa
dduas => đúa
dduaw => đưa
dduawf => đừa
dduawj => đựa
dduawr => đửa
dduaws => đứa
dduawx => đữa
dduax => đũa
dducj => đục
dducs => đúc
dducwj => đực
dducws => đức
dduezf => đuề
dduenhzr => đuểnh
ddui => đui
dduif => đùi
dduij => đụi
dduir => đủi
dduis => đúi
dduix => đũi
ddum => đum
ddumf => đùm
ddumj => đụm
ddums => đúm
ddumw => đưm
ddumwf => đừm
ddun => đun
ddunf => đùn
ddunj => đụn
ddunr => đủn
dduns => đún
ddunwf => đừn
ddunwj => đựn
ddunx => đũn
ddung => đung
ddungf => đùng
ddungj => đụng
ddungr => đủng
ddungs => đúng
ddungw => đưng
ddungwf => đừng
ddungwj => đựng
ddungwr => đửng
ddungws => đứng
ddungwx => đững
ddungx => đũng
ddunhwf => đừnh
ddunhws => đứnh
dduowf => đườ
dduowj => đượ
dduocwj => được
dduocws => đước
dduoczj => đuộc
dduoczs => đuốc
dduoiw => đươi
dduoiwf => đười
dduoiwj => đượi
dduoiwr => đưởi
dduoiws => đưới
dduoiz => đuôi
dduoizf => đuồi
dduoizj => đuội
dduoizr => đuổi
dduoizs => đuối
dduoizx => đuỗi
dduomw => đươm
dduomwf => đườm
dduomwj => đượm
dduomwr => đưởm
dduomzf => đuồm
dduomzj => đuộm
dduomzr => đuổm
dduonw => đươn
dduonwf => đườn
dduonwj => đượn
dduonwx => đưỡn
dduonz => đuôn
dduonzf => đuồn
dduonzx => đuỗn
dduong => đuong
dduongw => đương
dduongwf => đường
dduongwj => đượng
dduongwr => đưởng
dduongws => đướng
dduongwx => đưỡng
dduongz => đuông
dduongzs => đuống
dduotwj => đượt
dduotws => đướt
dduotzj => đuột
dduotzs => đuốt
dduouwf => đườu
ddupj => đụp
ddups => đúp
ddutj => đụt
dduts => đút
ddutwj => đựt
ddutws => đứt
dduuw => đưu
dduuws => đứu
dduy => đuy
dduy => đuy
dduya => đuya
dduychj => đuỵch
dduyenz => đuyên
dduyenzj => đuyện
dduyetzs => đuyết
dduyn => đuyn
dduynhf => đuỳnh
ddy => đy
de => de
def => dè
dej => dẹ
der => dẻ
des => dé
dex => dẽ
dez => dê
dezf => dề
dezj => dệ
dezr => dể
dezs => dế
dezx => dễ
decs => déc
dechzs => dếch
dem => dem
demf => dèm
demj => dẹm
dems => dém
demz => dêm
demzj => dệm
den => den
denf => dèn
denj => dẹn
dens => dén
denz => dên
denzf => dền
denzj => dện
denzs => dến
denzx => dễn
deng => deng
dengs => déng
denhz => dênh
denhzf => dềnh
denhzr => dểnh
denhzs => dếnh
deo => deo
deof => dèo
deoj => dẹo
deor => dẻo
deos => déo
deox => dẽo
depj => dẹp
deps => dép
depzj => dệp
depzs => dếp
detj => dẹt
dets => dét
detzj => dệt
detzs => dết
deuzf => dều
deuzj => dệu
deuzr => dểu
deuzs => dếu
deuzx => dễu
di => di
dif => dì
dij => dị
dir => dỉ
dis => dí
dix => dĩ
dia => dia
diaf => dìa
diaj => dịa
dias => día
diax => dĩa
dicj => dịc
dics => díc
dichj => dịch
dichs => dích
dieczj => diệc
dieczs => diếc
diemz => diêm
diemzf => diềm
diemzj => diệm
diemzr => diểm
diemzs => diếm
diemzx => diễm
dienz => diên
dienzf => diền
dienzj => diện
dienzr => diển
dienzs => diến
dienzx => diễn
diengz => diêng
diengzf => diềng
diengzr => diểng
diengzs => diếng
diepzj => diệp
diepzs => diếp
dietzj => diệt
dietzs => diết
dieuz => diêu
dieuzf => diều
dieuzj => diệu
dieuzr => diểu
dieuzs => diếu
dieuzx => diễu
dim => dim
dimf => dìm
dimr => dỉm
din => din
dinf => dìn
dinj => dịn
dins => dín
dinx => dĩn
ding => ding
dinh => dinh
dinhf => dình
dinhj => dịnh
dinhr => dỉnh
dinhs => dính
dinhx => dĩnh
dipj => dịp
dips => díp
ditj => dịt
dits => dít
diu => diu
diuf => dìu
diuj => dịu
diur => dỉu
dius => díu
diux => dĩu
do => do
dof => dò
doj => dọ
dor => dỏ
dos => dó
dow => dơ
dowf => dờ
dowj => dợ
dowr => dở
dows => dớ
dowx => dỡ
dox => dõ
doz => dô
dozf => dồ
dozj => dộ
dozr => dổ
dozs => dố
dozx => dỗ
doa => doa
doaj => dọa
doas => dóa
doai => doai
doais => doái
doaix => doãi
doan => doan
doanf => doàn
doanj => doạn
doanr => doản
doans => doán
doanx => doãn
doang => doang
doangs => doáng
doangw => doăng
doangx => doãng
doanh => doanh
doanhj => doạnh
doanhr => doảnh
doatj => doạt
docj => dọc
docs => dóc
doczj => dộc
doczs => dốc
dochzs => dốch
doe => doe
doex => dõe
doem => doem
doen => doen
doi => doi
doif => dòi
doij => dọi
doir => dỏi
dois => dói
doiw => dơi
doiwf => dời
doiwj => dợi
doiwr => dởi
doiws => dới
doiwx => dỡi
doix => dõi
doiz => dôi
doizf => dồi
doizj => dội
doizr => dổi
doizs => dối
doizx => dỗi
dom => dom
domf => dòm
domr => dỏm
domw => dơm
domwf => dờm
domwj => dợm
domwr => dởm
domx => dõm
domzr => dổm
don => don
donf => dòn
donj => dọn
donr => dỏn
dons => dón
donw => dơn
donwf => dờn
donwj => dợn
donwr => dởn
donws => dớn
donwx => dỡn
donx => dõn
donz => dôn
donzf => dồn
donzj => dộn
donzs => dốn
donzx => dỗn
dong => dong
dongf => dòng
dongj => dọng
dongr => dỏng
dongs => dóng
dongw => dơng
dongwx => dỡng
dongx => dõng
dongz => dông
dongzf => dồng
dongzj => dộng
dongzs => dống
dongzx => dỗng
donh => donh
doo => doo
doocj => doọc
doom => doom
doon => doon
doong => doong
dopj => dọp
dopws => dớp
dopzj => dộp
dopzs => dốp
dotj => dọt
dots => dót
dotwj => dợt
dotws => dớt
dotzj => dột
dotzs => dốt
du => du
duf => dù
duj => dụ
dur => dủ
dus => dú
duw => dư
duwf => dừ
duwj => dự
duwr => dử
duws => dứ
duwx => dữ
dux => dũ
dua => dua
duaf => dùa
duaj => dụa
duar => dủa
duas => dúa
duaw => dưa
duawf => dừa
duawj => dựa
duawr => dửa
duaws => dứa
duawx => dữa
duax => dũa
duazf => dùâ
duazx => dũâ
duanz => duân
duanzf => duần
duanzj => duận
duanzr => duẩn
duanzs => duấn
duanzx => duẫn
duangzf => duầng
duatzj => duật
duatzs => duất
ducj => dục
ducs => dúc
ducwj => dực
ducws => dức
duchj => dụch
duchs => dúch
duez => duê
duezj => duệ
duezs => duế
duenhzf => duềnh
dui => dui
duif => dùi
duij => dụi
duir => dủi
duis => dúi
duix => dũi
dum => dum
dumf => dùm
dumj => dụm
dumr => dủm
dums => dúm
dumx => dũm
dun => dun
dunf => dùn
dunj => dụn
duns => dún
dunwj => dựn
dunx => dũn
dung => dung
dungf => dùng
dungj => dụng
dungr => dủng
dungs => dúng
dungw => dưng
dungwf => dừng
dungwj => dựng
dungwr => dửng
dungws => dứng
dungwx => dững
dungx => dũng
dunh => dunh
dunhj => dụnh
duo => duo
duowj => dượ
duows => dướ
duowx => dưỡ
duocwj => dược
duocws => dước
duoczj => duộc
duoczs => duốc
duoi => duoi
duoiw => dươi
duoiwf => dười
duoiwj => dượi
duoiwr => dưởi
duoiws => dưới
duoiwx => dưỡi
duoiz => duôi
duoizj => duội
duoizr => duổi
duoizs => duối
duoizx => duỗi
duomwj => dượm
duomz => duôm
duomzf => duồm
duomzj => duộm
duon => duon
duonw => dươn
duonwf => dườn
duonws => dướn
duonwx => dưỡn
duonz => duôn
duonzx => duỗn
duong => duong
duongw => dương
duongwf => dường
duongwj => dượng
duongwr => dưởng
duongws => dướng
duongwx => dưỡng
duongz => duông
duongzf => duồng
duonhw => dươnh
duonhwf => dườnh
duopws => dướp
duotwj => dượt
duotws => dướt
duotzj => duột
dupj => dụp
dups => dúp
dutj => dụt
duts => dút
dutwj => dựt
dutws => dứt
duuw => dưu
duuwj => dựu
duuwx => dữu
duy => duy
duyf => dùy
duyj => dụy
duyr => dủy
duyx => dũy
duyenz => duyên
duyenzf => duyền
duyenzj => duyện
duyenzr => duyển
duyenzs => duyến
duyenzx => duyễn
duyenhzf => duyềnh
duyetzj => duyệt
duyetzs => duyết
duynh => duynh
duynhf => duỳnh
duyps => duýp
duyts => duýt
dy => dy
dyj => dỵ
dys => dý
dyx => dỹ
e => e
ef => è
ej => ẹ
er => ẻ
es => é
ex => ẽ
ez => ê
ezf => ề
ezj => ệ
ezr => ể
ezs => ế
ezx => ễ
ecj => ẹc
ecs => éc
eczj => ệc
eczs => ếc
echj => ẹch
echs => éch
echzj => ệch
echzs => ếch
em => em
emf => èm
emj => ẹm
emr => ẻm
ems => ém
emz => êm
emzf => ềm
emzj => ệm
emzr => ểm
emzs => ếm
emzx => ễm
en => en
enf => èn
enj => ẹn
enr => ẻn
ens => én
enx => ẽn
enz => ên
enzf => ền
enzj => ện
enzr => ển
enzs => ến
enzx => ễn
eng => eng
engf => èng
engj => ẹng
engr => ẻng
engz => êng
engzj => ệng
engzs => ếng
engzx => ễng
enh => enh
enhz => ênh
enhzf => ềnh
enhzj => ệnh
enhzr => ểnh
enhzs => ếnh
enhzx => ễnh
eo => eo
eof => èo
eoj => ẹo
eor => ẻo
eos => éo
eox => ẽo
epj => ẹp
eps => ép
epzj => ệp
epzs => ếp
etj => ẹt
ets => ét
etzj => ệt
etzs => ết
euz => êu
euzf => ều
euzj => ệu
euzr => ểu
euzs => ếu
euzx => ễu
ga => ga
gaf => gà
gaj => gạ
gar => gả
gas => gá
gaw => gă
gawj => gặ
gax => gã
gaz => gâ
gazf => gầ
gacj => gạc
gacs => gác
gacwj => gặc
gacws => gắc
gaczs => gấc
gachj => gạch
gachs => gách
gai => gai
gaif => gài
gaij => gại
gair => gải
gais => gái
gaix => gãi
gaizs => gấi
gam => gam
gamf => gàm
gamj => gạm
gamr => gảm
gams => gám
gamw => găm
gamwf => gằm
gamwj => gặm
gamws => gắm
gamz => gâm
gamzf => gầm
gamzj => gậm
gamzr => gẩm
gamzs => gấm
gamzx => gẫm
gan => gan
ganf => gàn
ganj => gạn
gans => gán
ganw => găn
ganwf => gằn
ganwj => gặn
ganws => gắn
ganz => gân
ganzf => gần
ganzj => gận
ganzr => gẩn
ganzs => gấn
ganzx => gẫn
gang => gang
gangf => gàng
gangr => gảng
gangs => gáng
gangw => găng
gangwf => gằng
gangwj => gặng
gangwr => gẳng
gangws => gắng
gangwx => gẵng
ganh => ganh
ganhf => gành
ganhj => gạnh
ganhr => gảnh
ganhs => gánh
ganhx => gãnh
gao => gao
gaof => gào
gaoj => gạo
gaos => gáo
gaox => gão
gaozs => gáô
gapj => gạp
gaps => gáp
gapwj => gặp
gapws => gắp
gapzj => gập
gapzs => gấp
gatj => gạt
gats => gát
gatwj => gặt
gatws => gắt
gatzj => gật
gatzs => gất
gau => gau
gauf => gàu
gaus => gáu
gauz => gâu
gauzf => gầu
gauzj => gậu
gauzs => gấu
gauzx => gẫu
gay => gay
gayf => gày
gayj => gạy
gayr => gảy
gays => gáy
gayx => gãy
gayz => gây
gayzf => gầy
gayzj => gậy
gayzr => gẩy
gayzs => gấy
gayzx => gẫy
ge => ge
gef => gè
ges => gé
gex => gẽ
gez => gê
gezf => gề
gezj => gệ
gezs => gế
gecs => géc
gechzs => gếch
gem => gem
gems => gém
gemz => gêm
gen => gen
genf => gèn
genz => gên
genzx => gễn
geng => geng
genhzf => gềnh
genhzj => gệnh
geo => geo
geoj => gẹo
geps => gép
gets => gét
getzj => gệt
getzs => gết
gha => gha
ghas => ghá
ghax => ghã
ghaczs => ghấc
ghachj => ghạch
ghai => ghai
ghamw => ghăm
ghan => ghan
ghans => ghán
ghanws => ghắn
ghanz => ghân
ghanzf => ghần
ghang => ghang
ghanh => ghanh
ghanhf => ghành
ghanhs => ghánh
ghapws => ghắp
ghapzj => ghập
ghatws => ghắt
ghayzf => ghầy
ghe => ghe
ghef => ghè
ghej => ghẹ
gher => ghẻ
ghes => ghé
ghex => ghẽ
ghez => ghê
ghezf => ghề
ghezj => ghệ
ghezs => ghế
ghecs => ghéc
ghechzs => ghếch
ghemj => ghẹm
ghems => ghém
ghemz => ghêm
ghen => ghen
ghenf => ghèn
ghenj => ghẹn
ghenr => ghẻn
ghens => ghén
ghenx => ghẽn
ghenz => ghên
ghenzr => ghển
ghenzs => ghến
ghenhz => ghênh
ghenhzf => ghềnh
ghenhzr => ghểnh
ghenhzs => ghếnh
ghenhzx => ghễnh
gheof => ghèo
gheoj => ghẹo
gheos => ghéo
gheps => ghép
ghetj => ghẹt
ghets => ghét
ghetzj => ghệt
ghetzs => ghết
ghi => ghi
ghif => ghì
ghij => ghị
ghir => ghỉ
ghis => ghí
ghix => ghĩ
ghia => ghia
ghiax => ghĩa
ghichj => ghịch
ghichs => ghích
ghieczs => ghiếc
ghiemz => ghiêm
ghiemzj => ghiệm
ghienz => ghiên
ghienzf => ghiền
ghienzj => ghiện
ghienzs => ghiến
ghiengzf => ghiềng
ghiepzj => ghiệp
ghiepzs => ghiếp
ghietzj => ghiệt
ghim => ghim
ghimf => ghìm
ghims => ghím
ghin => ghin
ghinf => ghìn
ghinhf => ghình
ghinhr => ghỉnh
ghips => ghíp
ghitj => ghịt
ghits => ghít
ghiuj => ghịu
ghius => ghíu
gho => gho
ghof => ghò
ghowf => ghờ
ghowr => ghở
ghowx => ghỡ
ghozf => ghồ
ghozr => ghổ
ghozx => ghỗ
ghom => ghom
ghomwf => ghờm
ghomws => ghớm
ghong => ghong
ghongzf => ghồng
ghops => ghóp
ghots => ghót
ghu => ghu
ghur => ghủ
ghuanzr => ghuẩn
ghunw => ghưn
ghupj => ghụp
gi => gi
gif => gì
gij => gị
gir => gỉ
gis => gí
gix => gĩ
gia => gia
giaf => già
giaj => giạ
giar => giả
gias => giá
giax => giã
giaz => giâ
giazj => giậ
giazs => giấ
giacj => giạc
giacs => giác
giacwj => giặc
giacws => giắc
giaczj => giậc
giaczs => giấc
giai => giai
giaif => giài
giair => giải
giais => giái
giaix => giãi
giaizr => giẩi
giam => giam
giamf => giàm
giamj => giạm
giamr => giảm
giams => giám
giamw => giăm
giamwf => giằm
giamwj => giặm
giamws => giắm
giamwx => giẵm
giamx => giãm
giamz => giâm
giamzf => giầm
giamzj => giậm
giamzr => giẩm
giamzs => giấm
giamzx => giẫm
gian => gian
gianf => giàn
gianj => giạn
gianr => giản
gians => gián
gianw => giăn
gianwf => giằn
gianwj => giặn
gianx => giãn
gianz => giân
gianzf => giần
gianzj => giận
gianzx => giẫn
giang => giang
giangf => giàng
giangj => giạng
giangr => giảng
giangs => giáng
giangw => giăng
giangwf => giằng
giangwr => giẳng
giangws => giắng
giangx => giãng
giangz => giâng
giangzs => giấng
gianh => gianh
gianhf => giành
gianhr => giảnh
gianhs => giánh
giao => giao
giaof => giào
giaoj => giạo
giaor => giảo
giaos => giáo
giaox => gião
giaps => giáp
giapzj => giập
giapzs => giấp
giatj => giạt
giats => giát
giatwj => giặt
giatws => giắt
giatzj => giật
giatzs => giất
giau => giau
giauf => giàu
giaur => giảu
giaus => giáu
giauz => giâu
giauzf => giầu
giauzj => giậu
giauzs => giấu
giauzx => giẫu
giay => giay
giayf => giày
giayj => giạy
giayr => giảy
giays => giáy
giayx => giãy
giayz => giây
giayzf => giầy
giayzj => giậy
giayzr => giẩy
giayzs => giấy
giayzx => giẫy
gics => gíc
gichs => gích
gie => gie
gief => giè
gier => giẻ
gies => gié
giex => giẽ
giez => giê
giezf => giề
giezs => giế
giecs => giéc
gieczs => giếc
giem => giem
giemf => gièm
giemz => giêm
giemzs => giếm
gien => gien
gienzf => giền
gienzj => giện
gienzs => giến
gieng => gieng
giengz => giêng
giengzf => giềng
giengzs => giếng
gienhzf => giềnh
gienhzs => giếnh
gieo => gieo
gieof => gièo
gieor => giẻo
giepj => giẹp
gieps => giép
giepzs => giếp
giets => giét
gietzj => giệt
gietzs => giết
gieuzs => giếu
gieuzx => giễu
gim => gim
gimf => gìm
gimr => gỉm
gin => gin
ginf => gìn
gins => gín
ging => ging
ginh => ginh
ginhf => gình
gio => gio
giof => giò
gioj => giọ
gior => giỏ
gios => gió
giow => giơ
giowf => giờ
giowr => giở
giows => giớ
giowx => giỡ
giox => giõ
gioz => giô
giozr => giổ
giozs => giố
giozx => giỗ
gioa => gioa
gioas => gióa
gioan => gioan
gioans => gioán
gioangw => gioăng
gioangx => gioãng
giocj => giọc
gioczj => giộc
gioczs => giốc
gioi => gioi
gioif => giòi
gioij => giọi
gioir => giỏi
giois => giói
gioiw => giơi
gioiwf => giời
gioiwj => giợi
gioiwr => giởi
gioiws => giới
gioix => giõi
gioizf => giồi
gioizj => giội
gioizr => giổi
gioizs => giối
gioizx => giỗi
gioms => gióm
giomwf => giờm
giomz => giôm
giomzf => giồm
gion => gion
gionf => giòn
gionj => giọn
gions => gión
gionw => giơn
gionwr => giởn
gionws => giớn
gionwx => giỡn
gionx => giõn
gionz => giôn
gionzj => giộn
gionzs => giốn
giong => giong
giongf => giòng
giongj => giọng
giongr => giỏng
giongs => gióng
giongx => giõng
giongz => giông
giongzf => giồng
giongzj => giộng
giongzr => giổng
giongzs => giống
giongzx => giỗng
gionhzs => giốnh
gioocs => gioóc
gioong => gioong
gioongf => gioòng
gioongr => gioỏng
giops => gióp
giopzj => giộp
giopzs => giốp
giotj => giọt
giots => giót
giotws => giớt
giotzj => giột
giotzs => giốt
gipj => gịp
gips => gíp
gits => gít
giu => giu
gius => giú
giuw => giư
giuwf => giừ
giuwj => giự
giuwr => giử
giuws => giứ
giuwx => giữ
giux => giũ
giua => giua
giuaf => giùa
giuaj => giụa
giuaw => giưa
giuawf => giừa
giuawr => giửa
giuaws => giứa
giuawx => giữa
giuax => giũa
giucj => giục
giucs => giúc
giuif => giùi
giuij => giụi
giuis => giúi
giuiwr => giửi
giuix => giũi
gium => gium
giumf => giùm
giumj => giụm
giums => giúm
giun => giun
giuns => giún
giung => giung
giuowf => giườ
giuoczj => giuộc
giuoczs => giuốc
giuoiws => giưới
giuonwf => giườn
giuong => giuong
giuongw => giương
giuongwf => giường
giuongwj => giượng
giuongwr => giưởng
giuongws => giướng
giupj => giụp
giups => giúp
giupws => giứp
giuts => giút
giutwj => giựt
giutws => giứt
giuuwx => giữu
giuy => giuy
giuyps => giuýp
go => go
gof => gò
goj => gọ
gor => gỏ
gos => gó
gow => gơ
gowf => gờ
gowj => gợ
gowr => gở
gows => gớ
gowx => gỡ
gox => gõ
goz => gô
gozf => gồ
gozj => gộ
gozr => gổ
gozs => gố
gozx => gỗ
goa => goa
goaj => gọa
goar => gỏa
goas => góa
goacs => goác
goai => goai
goaif => goài
goair => goải
goais => goái
goam => goam
goamj => goạm
goamwj => goặm
goan => goan
goangf => goàng
goangr => goảng
goaps => goáp
goay => goay
gocj => gọc
gocs => góc
gocws => gớc
goczj => gộc
goczs => gốc
goe => goe
goen => goen
goi => goi
goif => gòi
goij => gọi
goir => gỏi
gois => gói
goiw => gơi
goiwf => gời
goiwj => gợi
goiwr => gởi
goiws => gới
goix => gõi
goiz => gôi
goizf => gồi
goizj => gội
goizs => gối
goizx => gỗi
gom => gom
gomf => gòm
gomj => gọm
goms => góm
gomw => gơm
gomwf => gờm
gomwr => gởm
gomws => gớm
gomz => gôm
gomzf => gồm
gomzj => gộm
gomzr => gổm
gomzs => gốm
gon => gon
gonf => gòn
gonj => gọn
gonr => gỏn
gons => gón
gonw => gơn
gonwf => gờn
gonwj => gợn
gonz => gôn
gonzf => gồn
gonzs => gốn
gong => gong
gongf => gòng
gongj => gọng
gongr => gỏng
gongx => gõng
gongz => gông
gongzf => gồng
gongzs => gống
gonhzf => gồnh
goo => goo
goocs => goóc
goon => goon
goong => goong
goongf => goòng
gopj => gọp
gops => góp
gopwj => gợp
gopws => gớp
gopzj => gộp
gopzs => gốp
gotj => gọt
gots => gót
gotwj => gợt
gotws => gớt
gotzj => gột
gotzs => gốt
gu => gu
guf => gù
guj => gụ
gur => gủ
gus => gú
guw => gư
guwf => gừ
guwj => gự
guwr => gử
guws => gứ
guwx => gữ
gux => gũ
gua => gua
guaf => gùa
guaj => gụa
guar => gủa
guas => gúa
guawf => gừa
guawj => gựa
guawr => gửa
guaws => gứa
guawx => gữa
guanzj => guận
guayz => guây
gucj => gục
gucs => gúc
gucwj => gực
guetzs => guết
gui => gui
guif => gùi
guij => gụi
guir => gủi
guiw => gưi
guiwf => gừi
guiwr => gửi
guiws => gứi
guiwx => gữi
guix => gũi
gum => gum
gumf => gùm
gun => gun
gunr => gủn
gung => gung
gungf => gùng
gungw => gưng
gungwf => gừng
guo => guo
guoczj => guộc
guoczs => guốc
guoiw => gươi
guoiwf => gười
guoiws => gưới
guom => guom
guomw => gươm
guomwf => gườm
guomwj => gượm
guonw => gươn
guonzf => guồn
guonzj => guộn
guong => guong
guongw => gương
guongwf => gường
guongwj => gượng
guongwr => gưởng
guongws => gướng
guongwx => gưỡng
guongz => guông
guongzf => guồng
guongzj => guộng
guotzj => guột
gupj => gụp
gups => gúp
guts => gút
guuwr => gửu
guy => guy
guyenz => guyên
guyenzf => guyền
guyenzj => guyện
guyenzx => guyễn
guyetzj => guyệt
guyetzs => guyết
guym => guym
guyn => guyn
gy => gy
gyf => gỳ
ha => ha
haf => hà
haj => hạ
har => hả
has => há
hawf => hằ
hawr => hẳ
hax => hã
haz => hâ
hazf => hầ
hazj => hậ
hazs => hấ
hacj => hạc
hacs => hác
hacwj => hặc
hacws => hắc
haczj => hậc
haczs => hấc
hachj => hạch
hachs => hách
hai => hai
haif => hài
haij => hại
hair => hải
hais => hái
haix => hãi
ham => ham
hamf => hàm
hamj => hạm
hamr => hảm
hams => hám
hamw => hăm
hamwf => hằm
hamwr => hẳm
hamws => hắm
hamwx => hẵm
hamx => hãm
hamz => hâm
hamzf => hầm
hamzj => hậm
hamzr => hẩm
hamzs => hấm
hamzx => hẫm
han => han
hanf => hàn
hanj => hạn
hanr => hản
hans => hán
hanw => hăn
hanwf => hằn
hanwj => hặn
hanwr => hẳn
hanws => hắn
hanwx => hẵn
hanx => hãn
hanz => hân
hanzf => hần
hanzj => hận
hanzr => hẩn
hanzs => hấn
hanzx => hẫn
hang => hang
hangf => hàng
hangj => hạng
hangr => hảng
hangs => háng
hangw => hăng
hangwf => hằng
hangwj => hặng
hangwr => hẳng
hangws => hắng
hangwx => hẵng
hangx => hãng
hangz => hâng
hangzf => hầng
hangzj => hậng
hangzr => hẩng
hangzs => hấng
hangzx => hẫng
hanh => hanh
hanhf => hành
hanhj => hạnh
hanhr => hảnh
hanhs => hánh
hanhx => hãnh
hao => hao
haof => hào
haoj => hạo
haor => hảo
haos => háo
haox => hão
haozs => háô
hapj => hạp
haps => háp
hapwj => hặp
hapws => hắp
hapzj => hập
hapzs => hấp
hatj => hạt
hats => hát
hatwj => hặt
hatws => hắt
hatzj => hật
hatzs => hất
hau => hau
hauf => hàu
hauj => hạu
haur => hảu
haus => háu
haux => hãu
hauz => hâu
hauzf => hầu
hauzj => hậu
hauzr => hẩu
hauzs => hấu
hauzx => hẫu
hay => hay
hayf => hày
hayj => hạy
hayr => hảy
hays => háy
hayx => hãy
hayz => hây
hayzf => hầy
hayzj => hậy
hayzr => hẩy
hayzs => hấy
he => he
hef => hè
hej => hẹ
her => hẻ
hes => hé
hex => hẽ
hez => hê
hezf => hề
hezj => hệ
hezr => hể
hezs => hế
hezx => hễ
hecs => héc
hechzj => hệch
hechzs => hếch
hem => hem
hemf => hèm
hemj => hẹm
hemr => hẻm
hems => hém
hemx => hẽm
hemz => hêm
hemzr => hểm
hemzs => hếm
hen => hen
henf => hèn
henj => hẹn
henr => hẻn
hens => hén
henz => hên
henzf => hền
henzj => hện
henzr => hển
henzs => hến
henzx => hễn
heng => heng
hengs => héng
hengz => hêng
henhz => hênh
henhzf => hềnh
henhzj => hệnh
henhzr => hểnh
henhzs => hếnh
henhzx => hễnh
heo => heo
heof => hèo
heoj => hẹo
heor => hẻo
heos => héo
hepj => hẹp
heps => hép
hepzj => hệp
hepzs => hếp
hetj => hẹt
hets => hét
hetzj => hệt
hetzs => hết
heuz => hêu
heuzf => hều
heuzj => hệu
heuzr => hểu
heuzs => hếu
hi => hi
hif => hì
hij => hị
hir => hỉ
his => hí
hix => hĩ
hia => hia
hiaf => hìa
hiaj => hịa
hias => hía
hiax => hĩa
hics => híc
hichj => hịch
hichs => hích
hieczj => hiệc
hieczs => hiếc
hiemz => hiêm
hiemzf => hiềm
hiemzj => hiệm
hiemzr => hiểm
hiemzs => hiếm
hiemzx => hiễm
hienz => hiên
hienzf => hiền
hienzj => hiện
hienzr => hiển
hienzs => hiến
hienzx => hiễn
hiengz => hiêng
hiengzf => hiềng
hiengzj => hiệng
hiengzs => hiếng
hienhzj => hiệnh
hiepzj => hiệp
hiepzs => hiếp
hietzj => hiệt
hietzs => hiết
hieuz => hiêu
hieuzf => hiều
hieuzj => hiệu
hieuzr => hiểu
hieuzs => hiếu
hieuzx => hiễu
him => him
himf => hìm
himx => hĩm
hin => hin
hinf => hìn
hinj => hịn
hinr => hỉn
hins => hín
hinx => hĩn
hing => hing
hinh => hinh
hinhf => hình
hinhj => hịnh
hinhr => hỉnh
hinhs => hính
hinhx => hĩnh
hipj => hịp
hips => híp
hitj => hịt
hits => hít
hiu => hiu
hiuf => hìu
hiuj => hịu
hiur => hỉu
ho => ho
hof => hò
hoj => họ
hor => hỏ
hos => hó
how => hơ
howf => hờ
howj => hợ
howr => hở
hows => hớ
howx => hỡ
hox => hõ
hoz => hô
hozf => hồ
hozj => hộ
hozr => hổ
hozs => hố
hozx => hỗ
hoa => hoa
hoaf => hòa
hoaj => họa
hoar => hỏa
hoas => hóa
hoaw => hoă
hoawj => họă
hoax => hõa
hoacj => hoạc
hoacs => hoác
hoacwj => hoặc
hoacws => hoắc
hoachj => hoạch
hoachs => hoách
hoachwj => hoặch
hoai => hoai
hoaif => hoài
hoaij => hoại
hoair => hoải
hoais => hoái
hoaix => hoãi
hoamf => hoàm
hoamj => hoạm
hoams => hoám
hoamw => hoăm
hoamwf => hoằm
hoamwr => hoẳm
hoamws => hoắm
hoamx => hoãm
hoan => hoan
hoanf => hoàn
hoanj => hoạn
hoanr => hoản
hoans => hoán
hoanw => hoăn
hoanwf => hoằn
hoanx => hoãn
hoang => hoang
hoangf => hoàng
hoangj => hoạng
hoangr => hoảng
hoangs => hoáng
hoangw => hoăng
hoangwf => hoằng
hoangwr => hoẳng
hoangws => hoắng
hoangwx => hoẵng
hoangx => hoãng
hoanh => hoanh
hoanhf => hoành
hoanhj => hoạnh
hoanhr => hoảnh
hoanhs => hoánh
hoao => hoao
hoapj => hoạp
hoatj => hoạt
hoats => hoát
hoatwj => hoặt
hoatws => hoắt
hoay => hoay
hoayj => hoạy
hoays => hoáy
hoayws => hớăy
hocj => học
hocs => hóc
hocwj => hợc
hoczj => hộc
hoczs => hốc
hochj => họch
hoe => hoe
hoef => hòe
hoej => họe
hoer => hỏe
hoen => hoen
hoenr => hoẻn
hoetj => hoẹt
hoets => hoét
hoi => hoi
hoif => hòi
hoij => họi
hoir => hỏi
hois => hói
hoiw => hơi
hoiwf => hời
hoiwj => hợi
hoiwr => hởi
hoiws => hới
hoiwx => hỡi
hoix => hõi
hoiz => hôi
hoizf => hồi
hoizj => hội
hoizr => hổi
hoizs => hối
hoizx => hỗi
hom => hom
homf => hòm
homj => họm
homr => hỏm
homs => hóm
homw => hơm
homwf => hờm
homwj => hợm
homws => hớm
homwx => hỡm
homx => hõm
homz => hôm
homzf => hồm
homzj => hộm
homzr => hổm
homzx => hỗm
hon => hon
honf => hòn
honj => họn
honr => hỏn
hons => hón
honw => hơn
honwf => hờn
honwj => hợn
honwr => hởn
honws => hớn
honwx => hỡn
honx => hõn
honz => hôn
honzf => hồn
honzj => hộn
honzr => hổn
honzs => hốn
honzx => hỗn
hong => hong
hongf => hòng
hongj => họng
hongr => hỏng
hongs => hóng
hongw => hơng
hongz => hông
hongzf => hồng
hongzj => hộng
hongzr => hổng
hongzs => hống
hongzx => hỗng
hoo => hoo
hoocj => hoọc
hoocs => hoóc
hoon => hoon
hoong => hoong
hoongr => hoỏng
hopj => họp
hops => hóp
hopwj => hợp
hopws => hớp
hopzj => hộp
hopzs => hốp
hotj => họt
hots => hót
hotwj => hợt
hotws => hớt
hotzj => hột
hotzs => hốt
hu => hu
huf => hù
huj => hụ
hur => hủ
hus => hú
huw => hư
huwf => hừ
huwj => hự
huwr => hử
huws => hứ
huwx => hữ
hux => hũ
hua => hua
huaf => hùa
huar => hủa
huas => húa
huaw => hưa
huawf => hừa
huaws => hứa
huawx => hữa
huazj => hụâ
huanz => huân
huanzf => huần
huanzj => huận
huanzr => huẩn
huanzs => huấn
huanzx => huẫn
huatzs => huất
huayzf => huầy
hucj => hục
hucs => húc
hucwj => hực
hucws => hức
huez => huê
huezf => huề
huezj => huệ
huezr => huể
huezs => huế
huechzs => huếch
huenz => huên
huenzj => huện
huenhz => huênh
huenhzs => huếnh
huetzs => huết
hui => hui
huif => hùi
huij => hụi
huir => hủi
huis => húi
huiwr => hửi
huix => hũi
hum => hum
humf => hùm
humj => hụm
humr => hủm
hums => húm
humw => hưm
humwf => hừm
humx => hũm
hun => hun
hunf => hùn
hunj => hụn
hunr => hủn
hunw => hưn
hunx => hũn
hung => hung
hungf => hùng
hungj => hụng
hungr => hủng
hungs => húng
hungw => hưng
hungwf => hừng
hungwj => hựng
hungwr => hửng
hungws => hứng
hungwx => hững
hungx => hũng
hunh => hunh
hunhf => hùnh
huo => huo
huows => huớ
huocwj => hược
huocws => hước
huoczj => huộc
huoczs => huốc
huoi => huoi
huoiw => hươi
huoiz => huôi
huoizf => huồi
huoizj => huội
huoizr => huổi
huoizs => huối
huoizx => huỗi
huomw => hươm
huomwf => hườm
huomwj => hượm
huomws => hướm
huomz => huôm
huon => huon
huonw => hươn
huonwf => hườn
huonwj => hượn
huonwr => hưởn
huonws => hướn
huonwx => hưỡn
huonz => huôn
huonzf => huồn
huonzs => huốn
huong => huong
huongw => hương
huongwf => hường
huongwj => hượng
huongwr => hưởng
huongws => hướng
huongwx => hưỡng
huongz => huông
huongzf => huồng
huongzj => huộng
huongzr => huổng
huongzs => huống
huonh => huonh
huotws => hướt
huotzj => huột
huotzs => huốt
huouw => hươu
huouwj => hượu
huouws => hướu
hupj => hụp
hups => húp
hupwj => hựp
hutj => hụt
huts => hút
hutws => hứt
huuw => hưu
huuwf => hừu
huuwj => hựu
huuwr => hửu
huuws => hứu
huuwx => hữu
huy => huy
huyf => hùy
huyj => hụy
huyr => hủy
huys => húy
huyx => hũy
huya => huya
huyas => huýa
huychj => huỵch
huychs => huých
huyechzs => huyếch
huyenz => huyên
huyenzf => huyền
huyenzj => huyện
huyenzr => huyển
huyenzs => huyến
huyenzx => huyễn
huyenhz => huyênh
huyenhzj => huyệnh
huyepzs => huyếp
huyetzj => huyệt
huyetzs => huyết
huyn => huyn
huynf => huỳn
huyng => huyng
huyngf => huỳng
huynh => huynh
huynhf => huỳnh
huynhj => huỵnh
huynhr => huỷnh
huynhs => huýnh
huyts => huýt
hy => hy
hyf => hỳ
hyj => hỵ
hyr => hỷ
hys => hý
hyx => hỹ
i => i
if => ì
ij => ị
ir => ỉ
is => í
ix => ĩ
ia => ia
iaf => ìa
iaj => ịa
iar => ỉa
ias => ía
iax => ĩa
ichj => ịch
ichs => ích
im => im
imf => ìm
imr => ỉm
ims => ím
in => in
inf => ìn
inj => ịn
inr => ỉn
ins => ín
ing => ing
inh => inh
inhf => ình
inhj => ịnh
inhr => ỉnh
inhs => ính
inhx => ĩnh
ipj => ịp
ips => íp
itj => ịt
its => ít
iu => iu
iuf => ìu
iuj => ịu
iur => ỉu
ka => ka
kaf => kà
kaj => kạ
kar => kả
kas => ká
kacs => kác
kachj => kạch
kachs => kách
kai => kai
kaif => kài
kaij => kại
kair => kải
kais => kái
kam => kam
kamj => kạm
kamw => kăm
kamws => kắm
kamzs => kấm
kan => kan
kanf => kàn
kanj => kạn
kanw => kăn
kanzf => kần
kanzs => kấn
kang => kang
kangf => kàng
kangs => káng
kangw => kăng
kanh => kanh
kanhf => kành
kanhj => kạnh
kanhr => kảnh
kanhs => kánh
kao => kao
kaos => káo
kaps => káp
kapzj => kập
kats => kát
kau => kau
kauz => kâu
kauzj => kậu
kay => kay
kayz => kây
kayzj => kậy
ke => ke
kef => kè
kej => kẹ
ker => kẻ
kes => ké
kex => kẽ
kez => kê
kezf => kề
kezj => kệ
kezr => kể
kezs => kế
kezx => kễ
kecj => kẹc
kecs => kéc
kechzj => kệch
kechzs => kếch
kem => kem
kemf => kèm
kemj => kẹm
kemr => kẻm
kems => kém
kemx => kẽm
kemz => kêm
kemzf => kềm
kemzj => kệm
kemzr => kểm
kemzs => kếm
ken => ken
kenf => kèn
kenj => kẹn
kenr => kẻn
kens => kén
kenx => kẽn
kenz => kên
kenzf => kền
kenzj => kện
kenzs => kến
keng => keng
kengf => kèng
kengr => kẻng
kengs => kéng
kengx => kẽng
kengz => kêng
kenh => kenh
kenhr => kẻnh
kenhz => kênh
kenhzf => kềnh
kenhzj => kệnh
kenhzs => kếnh
kenhzx => kễnh
keo => keo
keof => kèo
keoj => kẹo
keor => kẻo
keos => kéo
keox => kẽo
kepj => kẹp
keps => kép
kepzs => kếp
ketj => kẹt
kets => két
ketzj => kệt
ketzs => kết
keuz => kêu
keuzf => kều
keuzj => kệu
keuzr => kểu
keuzs => kếu
kha => kha
khaf => khà
khaj => khạ
khar => khả
khas => khá
khaw => khă
khawr => khẳ
khaws => khắ
khax => khã
khazr => khẩ
khacj => khạc
khacs => khác
khacwj => khặc
khacws => khắc
khaczj => khậc
khaczs => khấc
khachj => khạch
khachs => khách
khai => khai
khaif => khài
khair => khải
khais => khái
khaiz => khâi
kham => kham
khamr => khảm
khams => khám
khamw => khăm
khamwf => khằm
khamwj => khặm
khamwr => khẳm
khamws => khắm
khamx => khãm
khamz => khâm
khamzf => khầm
khamzj => khậm
khamzr => khẩm
khamzs => khấm
khan => khan
khanf => khàn
khanj => khạn
khanr => khản
khans => khán
khanw => khăn
khanwf => khằn
khanwr => khẳn
khanws => khắn
khanx => khãn
khanz => khân
khanzf => khần
khanzj => khận
khanzr => khẩn
khanzs => khấn
khang => khang
khangf => khàng
khangj => khạng
khangr => khảng
khangs => kháng
khangw => khăng
khangwf => khằng
khangwj => khặng
khangwr => khẳng
khangws => khắng
khangz => khâng
khangzr => khẩng
khanh => khanh
khanhf => khành
khanhj => khạnh
khanhr => khảnh
khanhs => khánh
khanhwr => khẳnh
khao => khao
khaof => khào
khaoj => khạo
khaor => khảo
khaos => kháo
khapj => khạp
khaps => kháp
khapwj => khặp
khapws => khắp
khapzj => khập
khapzs => khấp
khatj => khạt
khats => khát
khatws => khắt
khatzj => khật
khatzs => khất
khau => khau
khauf => khàu
khaur => khảu
khaus => kháu
khauz => khâu
khauzf => khầu
khauzj => khậu
khauzr => khẩu
khauzs => khấu
khauzx => khẫu
khay => khay
khayf => khày
khayj => khạy
khayr => khảy
khays => kháy
khayz => khây
khayzj => khậy
khayzr => khẩy
khayzs => khấy
khe => khe
khef => khè
kher => khẻ
khes => khé
khex => khẽ
khez => khê
khezf => khề
khezj => khệ
khezr => khể
khezs => khế
khecj => khẹc
khechzj => khệch
khechzs => khếch
khem => khem
khemf => khèm
khemr => khẻm
khems => khém
khemz => khêm
khen => khen
khenf => khèn
khenr => khẻn
khens => khén
khenz => khên
khenzj => khện
khenzr => khển
khenzs => khến
kheng => kheng
khengf => khèng
khengs => khéng
khengz => khêng
khenhz => khênh
khenhzf => khềnh
khenhzj => khệnh
khenhzr => khểnh
khenhzs => khếnh
khenhzx => khễnh
kheo => kheo
kheof => khèo
kheor => khẻo
kheos => khéo
kheps => khép
khetj => khẹt
khets => khét
khetzj => khệt
khetzs => khết
kheuz => khêu
kheuzf => khều
kheuzr => khểu
kheuzs => khếu
khi => khi
khif => khì
khij => khị
khir => khỉ
khis => khí
khix => khĩ
khia => khia
khiaf => khìa
khiaj => khịa
khias => khía
khiax => khĩa
khics => khíc
khichj => khịch
khichs => khích
khieczs => khiếc
khiemz => khiêm
khiemzf => khiềm
khiemzj => khiệm
khiemzr => khiểm
khiemzs => khiếm
khienz => khiên
khienzf => khiền
khienzj => khiện
khienzr => khiển
khienzs => khiến
khienzx => khiễn
khiengz => khiêng
khiengzf => khiềng
khiengzj => khiệng
khiengzr => khiểng
khiengzs => khiếng
khiengzx => khiễng
khiepzj => khiệp
khiepzs => khiếp
khietzj => khiệt
khietzs => khiết
khieuz => khiêu
khieuzf => khiều
khieuzj => khiệu
khieuzr => khiểu
khieuzs => khiếu
khim => khim
khin => khin
khinf => khìn
khinr => khỉn
khins => khín
khing => khing
khingx => khĩng
khinh => khinh
khinhf => khình
khinhr => khỉnh
khinhs => khính
khinhx => khĩnh
khipj => khịp
khitj => khịt
khits => khít
khiu => khiu
khiuf => khìu
khiuj => khịu
khiur => khỉu
khius => khíu
kho => kho
khof => khò
khoj => khọ
khor => khỏ
khos => khó
khow => khơ
khowf => khờ
khowr => khở
khows => khớ
khox => khõ
khoz => khô
khozf => khồ
khozj => khộ
khozr => khổ
khozs => khố
khozx => khỗ
khoa => khoa
khoaf => khòa
khoaj => khọa
khoar => khỏa
khoas => khóa
khoacj => khoạc
khoacs => khoác
khoacwj => khoặc
khoacws => khoắc
khoachs => khoách
khoai => khoai
khoaif => khoài
khoaij => khoại
khoair => khoải
khoais => khoái
khoamw => khoăm
khoamwf => khoằm
khoamwj => khoặm
khoamwr => khoẳm
khoan => khoan
khoanf => khoàn
khoanr => khoản
khoans => khoán
khoanw => khoăn
khoanwr => khoẳn
khoanws => khoắn
khoang => khoang
khoangf => khoàng
khoangj => khoạng
khoangr => khoảng
khoangs => khoáng
khoangw => khoăng
khoangwr => khoẳng
khoangws => khoắng
khoangx => khoãng
khoanh => khoanh
khoanhf => khoành
khoanhr => khoảnh
khoanhs => khoánh
khoanhwr => khoẳnh
khoatj => khoạt
khoats => khoát
khoatws => khoắt
khoay => khoay
khoays => khoáy
khocj => khọc
khocs => khóc
khoczj => khộc
khoczs => khốc
khoe => khoe
khoef => khòe
khoer => khỏe
khoes => khóe
khoecs => khoéc
khoen => khoen
khoens => khoén
khoeng => khoeng
khoeo => khoeo
khoeof => khoèo
khoeor => khoẻo
khoets => khoét
khoi => khoi
khoij => khọi
khoir => khỏi
khois => khói
khoiw => khơi
khoiwf => khời
khoiwr => khởi
khoiws => khới
khoiz => khôi
khoizf => khồi
khoizr => khổi
khoizs => khối
khoizx => khỗi
khom => khom
khomf => khòm
khomj => khọm
khoms => khóm
khomw => khơm
khomwr => khởm
khomws => khớm
khomz => khôm
khomzj => khộm
khomzr => khổm
khomzs => khốm
khon => khon
khonf => khòn
khonj => khọn
khonr => khỏn
khons => khón
khonw => khơn
khonwr => khởn
khonz => khôn
khonzf => khồn
khonzj => khộn
khonzr => khổn
khonzs => khốn
khong => khong
khongf => khòng
khongj => khọng
khongr => khỏng
khongw => khơng
khongz => không
khongzf => khồng
khongzj => khộng
khongzr => khổng
khongzs => khống
khongzx => khỗng
khonhz => khônh
khoo => khoo
khoocj => khoọc
khoon => khoon
khoong => khoong
khoongf => khoòng
khoopj => khoọp
khops => khóp
khopwj => khợp
khopws => khớp
khopzj => khộp
khopzs => khốp
khotj => khọt
khots => khót
khotws => khớt
khotzj => khột
khotzs => khốt
khu => khu
khuf => khù
khuj => khụ
khur => khủ
khus => khú
khuw => khư
khuwf => khừ
khuwj => khự
khuwr => khử
khuws => khứ
khuwx => khữ
khua => khua
khuaf => khùa
khuar => khủa
khuas => khúa
khuaw => khưa
khuawf => khừa
khuawj => khựa
khuaws => khứa
khuaz => khuâ
khuazs => khúâ
khuanz => khuân
khuanzf => khuần
khuanzj => khuận
khuanzr => khuẩn
khuanzs => khuấn
khuanzx => khuẫn
khuangz => khuâng
khuatzs => khuất
khuayz => khuây
khuayzj => khuậy
khuayzr => khuẩy
khuayzs => khuấy
khucj => khục
khucs => khúc
khucwj => khực
khucws => khức
khuez => khuê
khuezr => khuể
khuechzs => khuếch
khuenzs => khuến
khuenhzf => khuềnh
khuenhzs => khuếnh
khuetzs => khuết
khui => khui
khuif => khùi
khuij => khụi
khuiw => khưi
khuiwr => khửi
khum => khum
khumf => khùm
khumj => khụm
khums => khúm
khumws => khứm
khun => khun
khunf => khùn
khunr => khủn
khuns => khún
khunw => khưn
khunwr => khửn
khunws => khứn
khung => khung
khungf => khùng
khungj => khụng
khungr => khủng
khungs => khúng
khungw => khưng
khungwf => khừng
khungwj => khựng
khunh => khunh
khuowf => khuờ
khuows => khuớ
khuocws => khước
khuoczs => khuốc
khuoiw => khươi
khuoiws => khưới
khuoizf => khuồi
khuoizr => khuổi
khuoizs => khuối
khuomw => khươm
khuomz => khuôm
khuon => khuon
khuonw => khươn
khuonws => khướn
khuonz => khuôn
khuonzr => khuổn
khuong => khuong
khuongw => khương
khuongwf => khường
khuongwr => khưởng
khuongws => khướng
khuongwx => khưỡng
khuongz => khuông
khuongzs => khuống
khuotws => khướt
khuouws => khướu
khups => khúp
khutj => khụt
khuts => khút
khuuw => khưu
khuuwf => khừu
khuuwr => khửu
khuuws => khứu
khuy => khuy
khuyj => khụy
khuyr => khủy
khuys => khúy
khuya => khuya
khuyaj => khuỵa
khuyar => khuỷa
khuyeczs => khuyếc
khuyechzs => khuyếch
khuyemzs => khuyếm
khuyenz => khuyên
khuyenzf => khuyền
khuyenzj => khuyện
khuyenzr => khuyển
khuyenzs => khuyến
khuyenzx => khuyễn
khuyenhzf => khuyềnh
khuyenhzs => khuyếnh
khuyetzj => khuyệt
khuyetzs => khuyết
khuyng => khuyng
khuynh => khuynh
khuynhf => khuỳnh
khuyu => khuyu
khuyuj => khuỵu
khuyur => khuỷu
khyr => khỷ
ki => ki
kif => kì
kij => kị
kir => kỉ
kis => kí
kix => kĩ
kia => kia
kiaf => kìa
kiaj => kịa
kiar => kỉa
kias => kía
kicj => kịc
kics => kíc
kichj => kịch
kichs => kích
kieczs => kiếc
kiemz => kiêm
kiemzf => kiềm
kiemzj => kiệm
kiemzr => kiểm
kiemzs => kiếm
kiemzx => kiễm
kienz => kiên
kienzf => kiền
kienzj => kiện
kienzr => kiển
kienzs => kiến
kienzx => kiễn
kiengz => kiêng
kiengzf => kiềng
kiengzr => kiểng
kiengzs => kiếng
kiengzx => kiễng
kienhz => kiênh
kiepzj => kiệp
kiepzs => kiếp
kietzj => kiệt
kietzs => kiết
kieuz => kiêu
kieuzf => kiều
kieuzj => kiệu
kieuzr => kiểu
kieuzs => kiếu
kieuzx => kiễu
kim => kim
kimf => kìm
kimj => kịm
kimr => kỉm
kims => kím
kimx => kĩm
kin => kin
kinf => kìn
kinj => kịn
kinr => kỉn
kins => kín
kinx => kĩn
king => king
kings => kíng
kinh => kinh
kinhf => kình
kinhj => kịnh
kinhr => kỉnh
kinhs => kính
kinhx => kĩnh
kipj => kịp
kips => kíp
kitj => kịt
kits => kít
kiu => kiu
kiuf => kìu
kiur => kỉu
kius => kíu
kiux => kĩu
ko => ko
kof => kò
koj => kọ
kos => kó
kow => kơ
kowf => kờ
kowx => kỡ
koz => kô
kozf => kồ
kozr => kổ
koa => koa
koachj => koạch
koaij => koại
koam => koam
koangr => koảng
koangs => koáng
koanh => koanh
koay => koay
kocj => kọc
koczs => kốc
koe => koe
koer => kỏe
koem => koem
koen => koen
koi => koi
koif => kòi
koiw => kơi
koiwf => kời
koiwr => kởi
koiz => kôi
koizs => kối
kom => kom
komf => kòm
komz => kôm
kon => kon
konf => kòn
kons => kón
konw => kơn
konws => kớn
konz => kôn
kong => kong
kongz => kông
kongzf => kồng
koo => koo
koocs => koóc
koom => koom
koon => koon
koong => koong
koongs => koóng
koonh => koonh
kops => kóp
kopwj => kợp
kopws => kớp
kopzs => kốp
kots => kót
kotwj => kợt
kotws => kớt
kotzs => kốt
ku => ku
kuf => kù
kur => kủ
kus => kú
kuw => kư
kuwj => kự
kua => kua
kuaw => kưa
kuawj => kựa
kuanzj => kuận
kuanzr => kuẩn
kuatzj => kuật
kucj => kục
kucs => kúc
kucwj => kực
kuezj => kuệ
kuengz => kuêng
kui => kui
kum => kum
kumw => kưm
kumwf => kừm
kun => kun
kuns => kún
kung => kung
kungr => kủng
kungw => kưng
kuo => kuo
kuoiwx => kưỡi
kuon => kuon
kuonz => kuôn
kuong => kuong
kuongw => kương
kuongwf => kường
kuopzs => kuốp
kuts => kút
kuy => kuy
kuyenz => kuyên
kuyng => kuyng
ky => ky
kyf => kỳ
kyj => kỵ
kyr => kỷ
kys => ký
kyx => kỹ
la => la
laf => là
laj => lạ
lar => lả
las => lá
law => lă
laws => lắ
lax => lã
laz => lâ
lazf => lầ
lazj => lậ
lazs => lấ
lazx => lẫ
lacj => lạc
lacs => lác
lacwj => lặc
lacws => lắc
laczj => lậc
laczs => lấc
lachj => lạch
lachs => lách
lai => lai
laif => lài
laij => lại
lair => lải
lais => lái
laix => lãi
laizj => lậi
lam => lam
lamf => làm
lamj => lạm
lamr => lảm
lams => lám
lamw => lăm
lamwf => lằm
lamwj => lặm
lamwr => lẳm
lamws => lắm
lamx => lãm
lamz => lâm
lamzf => lầm
lamzj => lậm
lamzr => lẩm
lamzs => lấm
lamzx => lẫm
lan => lan
lanf => làn
lanj => lạn
lanr => lản
lans => lán
lanw => lăn
lanwf => lằn
lanwj => lặn
lanwr => lẳn
lanws => lắn
lanwx => lẵn
lanx => lãn
lanz => lân
lanzf => lần
lanzj => lận
lanzr => lẩn
lanzs => lấn
lanzx => lẫn
lang => lang
langf => làng
langj => lạng
langr => lảng
langs => láng
langw => lăng
langwf => lằng
langwj => lặng
langwr => lẳng
langws => lắng
langwx => lẵng
langx => lãng
langz => lâng
langzf => lầng
langzj => lậng
langzs => lấng
langzx => lẫng
lanh => lanh
lanhf => lành
lanhj => lạnh
lanhr => lảnh
lanhs => lánh
lanhx => lãnh
lanhzj => lậnh
lao => lao
laof => lào
laoj => lạo
laor => lảo
laos => láo
laox => lão
laozj => lạô
lapj => lạp
laps => láp
lapwj => lặp
lapws => lắp
lapzj => lập
lapzs => lấp
latj => lạt
lats => lát
latwj => lặt
latws => lắt
latzj => lật
latzs => lất
lau => lau
lauf => làu
lauj => lạu
laur => lảu
laus => láu
lauz => lâu
lauzf => lầu
lauzj => lậu
lauzr => lẩu
lauzs => lấu
lauzx => lẫu
lay => lay
layf => lày
layj => lạy
layr => lảy
lays => láy
layx => lãy
layz => lây
layzf => lầy
layzj => lậy
layzr => lẩy
layzs => lấy
layzx => lẫy
le => le
lef => lè
lej => lẹ
ler => lẻ
les => lé
lex => lẽ
lez => lê
lezf => lề
lezj => lệ
lezr => lể
lezs => lế
lezx => lễ
lecj => lẹc
lecs => léc
leczj => lệc
leczs => lếc
lechzj => lệch
lechzs => lếch
lem => lem
lemf => lèm
lemj => lẹm
lemr => lẻm
lems => lém
lemz => lêm
lemzf => lềm
len => len
lenf => lèn
lenj => lẹn
lenr => lẻn
lens => lén
lenx => lẽn
lenz => lên
lenzf => lền
lenzj => lện
lenzr => lển
lenzs => lến
lenzx => lễn
leng => leng
lengf => lèng
lengj => lẹng
lengr => lẻng
lengs => léng
lengz => lêng
lenh => lenh
lenhf => lènh
lenhr => lẻnh
lenhz => lênh
lenhzf => lềnh
lenhzj => lệnh
lenhzs => lếnh
lenhzx => lễnh
leo => leo
leof => lèo
leoj => lẹo
leor => lẻo
leos => léo
leox => lẽo
lepj => lẹp
leps => lép
lepzs => lếp
letj => lẹt
lets => lét
letzj => lệt
letzs => lết
leuz => lêu
leuzf => lều
leuzj => lệu
leuzr => lểu
leuzs => lếu
leuzx => lễu
li => li
lif => lì
lij => lị
lir => lỉ
lis => lí
lix => lĩ
lia => lia
liaf => lìa
liaj => lịa
liar => lỉa
lias => lía
liax => lĩa
licj => lịc
lics => líc
lichj => lịch
lichs => lích
lieczj => liệc
lieczs => liếc
liemz => liêm
liemzf => liềm
liemzj => liệm
liemzr => liểm
liemzs => liếm
liemzx => liễm
lienz => liên
lienzf => liền
lienzj => liện
lienzr => liển
lienzs => liến
lienzx => liễn
liengz => liêng
liengzf => liềng
liengzj => liệng
liengzr => liểng
liengzs => liếng
liengzx => liễng
liepzj => liệp
liepzs => liếp
lietzj => liệt
lietzs => liết
lieuz => liêu
lieuzf => liều
lieuzj => liệu
lieuzr => liểu
lieuzs => liếu
lieuzx => liễu
lim => lim
limf => lìm
limj => lịm
limr => lỉm
lin => lin
linf => lìn
linj => lịn
lins => lín
linx => lĩn
ling => ling
lingf => lìng
linh => linh
linhf => lình
linhj => lịnh
linhr => lỉnh
linhs => lính
linhx => lĩnh
lipj => lịp
lips => líp
litj => lịt
lits => lít
liu => liu
liuf => lìu
liuj => lịu
liur => lỉu
lius => líu
liux => lĩu
lo => lo
lof => lò
loj => lọ
lor => lỏ
los => ló
low => lơ
lowf => lờ
lowj => lợ
lowr => lở
lows => lớ
lowx => lỡ
lox => lõ
loz => lô
lozf => lồ
lozj => lộ
lozr => lổ
lozs => lố
lozx => lỗ
loa => loa
loaf => lòa
loaj => lọa
loar => lỏa
loas => lóa
loax => lõa
loacj => loạc
loacs => loác
loachj => loạch
loachs => loách
loai => loai
loaif => loài
loaij => loại
loair => loải
loais => loái
loam => loam
loan => loan
loanf => loàn
loanj => loạn
loanr => loản
loans => loán
loanw => loăn
loanwf => loằn
loanx => loãn
loang => loang
loangf => loàng
loangj => loạng
loangr => loảng
loangs => loáng
loangw => loăng
loangwf => loằng
loangwj => loặng
loangws => loắng
loangx => loãng
loanh => loanh
loanhf => loành
loanhj => loạnh
loatj => loạt
loats => loát
loatwj => loặt
loatws => loắt
loay => loay
loayj => loạy
loays => loáy
locj => lọc
locs => lóc
loczj => lộc
loczs => lốc
lochs => lóch
loe => loe
loef => lòe
loej => lọe
loes => lóe
loem => loem
loen => loen
loenj => loẹn
loeng => loeng
loengr => loẻng
loeor => loẻo
loetj => loẹt
loets => loét
loi => loi
loif => lòi
loij => lọi
loir => lỏi
lois => lói
loiw => lơi
loiwf => lời
loiwj => lợi
loiwr => lởi
loiws => lới
loiwx => lỡi
loix => lõi
loiz => lôi
loizf => lồi
loizj => lội
loizr => lổi
loizs => lối
loizx => lỗi
lom => lom
lomf => lòm
lomj => lọm
lomr => lỏm
loms => lóm
lomw => lơm
lomwf => lờm
lomwj => lợm
lomwr => lởm
lomws => lớm
lomwx => lỡm
lomx => lõm
lomz => lôm
lomzf => lồm
lomzj => lộm
lomzr => lổm
lomzs => lốm
lon => lon
lonf => lòn
lonj => lọn
lonr => lỏn
lons => lón
lonw => lơn
lonwf => lờn
lonwj => lợn
lonwr => lởn
lonws => lớn
lonwx => lỡn
lonz => lôn
lonzf => lồn
lonzj => lộn
lonzr => lổn
lonzs => lốn
lonzx => lỗn
long => long
longf => lòng
longj => lọng
longr => lỏng
longs => lóng
longw => lơng
longwf => lờng
longwj => lợng
longws => lớng
longx => lõng
longz => lông
longzf => lồng
longzj => lộng
longzr => lổng
longzs => lống
longzx => lỗng
lonh => lonh
lonhr => lỏnh
lonhs => lónh
loo => loo
loocj => loọc
loocs => loóc
loom => loom
loon => loon
loong => loong
loongf => loòng
loongj => loọng
loongr => loỏng
loongs => loóng
lopj => lọp
lops => lóp
lopwj => lợp
lopws => lớp
lopzj => lộp
lopzs => lốp
lotj => lọt
lots => lót
lotwj => lợt
lotws => lớt
lotzj => lột
lotzs => lốt
lu => lu
luf => lù
luj => lụ
lur => lủ
lus => lú
luw => lư
luwf => lừ
luwj => lự
luwr => lử
luws => lứ
luwx => lữ
lux => lũ
lua => lua
luaf => lùa
luaj => lụa
luar => lủa
luas => lúa
luaw => lưa
luawf => lừa
luawj => lựa
luawr => lửa
luaws => lứa
luawx => lữa
luax => lũa
luaz => luâ
luazj => lụâ
luanz => luân
luanzf => luần
luanzj => luận
luanzr => luẩn
luanzs => luấn
luanzx => luẫn
luangz => luâng
luangzj => luậng
luapzj => luập
luatzj => luật
luayzj => luậy
lucj => lục
lucs => lúc
lucwj => lực
lucws => lức
luez => luê
luezj => luệ
luenz => luên
luenzj => luện
luenhz => luênh
luenhzx => luễnh
luetzj => luệt
lui => lui
luif => lùi
luij => lụi
luir => lủi
luis => lúi
luiwf => lừi
luiwj => lựi
luix => lũi
lum => lum
lumf => lùm
lumj => lụm
lumr => lủm
lums => lúm
lumw => lưm
lumwf => lừm
lumwj => lựm
lumx => lũm
lun => lun
lunf => lùn
lunj => lụn
lunr => lủn
luns => lún
lunw => lưn
lunws => lứn
lunx => lũn
lung => lung
lungf => lùng
lungj => lụng
lungr => lủng
lungs => lúng
lungw => lưng
lungwf => lừng
lungwj => lựng
lungwr => lửng
lungws => lứng
lungwx => lững
lungx => lũng
lunh => lunh
luo => luo
luowj => lượ
luows => lướ
luocwj => lược
luocws => lước
luoczj => luộc
luoczs => luốc
luoi => luoi
luoiw => lươi
luoiwf => lười
luoiwj => lượi
luoiwr => lưởi
luoiws => lưới
luoiwx => lưỡi
luoiz => luôi
luoizf => luồi
luoizj => luội
luoizs => luối
luom => luom
luomw => lươm
luomwf => lườm
luomwj => lượm
luomws => lướm
luomz => luôm
luomzj => luộm
luomzs => luốm
luon => luon
luonw => lươn
luonwf => lườn
luonwj => lượn
luonws => lướn
luonz => luôn
luonzf => luồn
luonzj => luộn
luonzs => luốn
luong => luong
luongw => lương
luongwf => lường
luongwj => lượng
luongwr => lưởng
luongws => lướng
luongwx => lưỡng
luongz => luông
luongzf => luồng
luongzj => luộng
luongzr => luổng
luongzs => luống
luongzx => luỗng
luonhwj => lượnh
luopws => lướp
luotwj => lượt
luotws => lướt
luotzj => luột
luotzs => luốt
lupj => lụp
lups => lúp
lutj => lụt
luts => lút
lutwj => lựt
lutws => lứt
luuw => lưu
luuwf => lừu
luuwj => lựu
luuwr => lửu
luuws => lứu
luuwx => lữu
luy => luy
luyf => lùy
luyj => lụy
luyr => lủy
luys => lúy
luyx => lũy
luya => luya
luychs => luých
luyenz => luyên
luyenzf => luyền
luyenzj => luyện
luyenzr => luyển
luyenzs => luyến
luyetzj => luyệt
luyn => luyn
luynh => luynh
luynhs => luýnh
luyts => luýt
ly => ly
lyf => lỳ
lyj => lỵ
lyr => lỷ
lys => lý
lyx => lỹ
ma => ma
maf => mà
maj => mạ
mar => mả
mas => má
maw => mă
mawj => mặ
maws => mắ
max => mã
maz => mâ
mazf => mầ
mazj => mậ
mazr => mẩ
mazs => mấ
mazx => mẫ
macj => mạc
macs => mác
macwj => mặc
macws => mắc
maczs => mấc
machj => mạch
machs => mách
machws => mắch
mai => mai
maif => mài
maij => mại
mair => mải
mais => mái
maix => mãi
mam => mam
mamf => màm
mams => mám
mamw => măm
mamwf => mằm
mamwj => mặm
mamwr => mẳm
mamws => mắm
mamx => mãm
mamz => mâm
mamzf => mầm
mamzj => mậm
mamzr => mẩm
mamzs => mấm
mamzx => mẫm
man => man
manf => màn
manj => mạn
manr => mản
mans => mán
manw => măn
manwf => mằn
manwj => mặn
manwr => mẳn
manws => mắn
manwx => mẵn
manx => mãn
manz => mân
manzf => mần
manzj => mận
manzr => mẩn
manzs => mấn
manzx => mẫn
mang => mang
mangf => màng
mangj => mạng
mangr => mảng
mangs => máng
mangw => măng
mangwf => mằng
mangwj => mặng
mangwr => mẳng
mangws => mắng
mangwx => mẵng
mangx => mãng
mangz => mâng
mangzs => mấng
manh => manh
manhf => mành
manhj => mạnh
manhr => mảnh
manhs => mánh
manhw => mănh
manhx => mãnh
mao => mao
maof => mào
maoj => mạo
maor => mảo
maos => máo
maox => mão
mapj => mạp
maps => máp
mapwj => mặp
mapws => mắp
mapzj => mập
mapzs => mấp
matj => mạt
mats => mát
matwj => mặt
matws => mắt
matzj => mật
matzs => mất
mau => mau
mauf => màu
mauj => mạu
maur => mảu
maus => máu
maux => mãu
mauz => mâu
mauzf => mầu
mauzj => mậu
mauzr => mẩu
mauzs => mấu
mauzx => mẫu
may => may
mayf => mày
mayj => mạy
mayr => mảy
mays => máy
mayx => mãy
mayz => mây
mayzf => mầy
mayzj => mậy
mayzr => mẩy
mayzs => mấy
mayzx => mẫy
me => me
mef => mè
mej => mẹ
mer => mẻ
mes => mé
mex => mẽ
mez => mê
mezf => mề
mezj => mệ
mezr => mể
mezs => mế
mezx => mễ
mecj => mẹc
mecs => méc
mechzs => mếch
mem => mem
memf => mèm
memr => mẻm
mems => mém
memx => mẽm
memz => mêm
memzf => mềm
memzr => mểm
memzs => mếm
memzx => mễm
men => men
menf => mèn
menj => mẹn
mens => mén
menz => mên
menzf => mền
menzj => mện
menzr => mển
menzs => mến
menzx => mễn
meng => meng
mengf => mèng
mengj => mẹng
mengz => mêng
mengzj => mệng
mengzs => mếng
menhj => mẹnh
menhz => mênh
menhzf => mềnh
menhzj => mệnh
menhzr => mểnh
menhzs => mếnh
menhzx => mễnh
meo => meo
meof => mèo
meoj => mẹo
meor => mẻo
meos => méo
meox => mẽo
mepj => mẹp
meps => mép
metj => mẹt
mets => mét
metzj => mệt
metzs => mết
meuz => mêu
meuzf => mều
meuzs => mếu
mi => mi
mif => mì
mij => mị
mir => mỉ
mis => mí
mix => mĩ
mia => mia
miaf => mìa
miaj => mịa
miar => mỉa
mias => mía
miax => mĩa
mics => míc
michj => mịch
michs => mích
mieczs => miếc
miemz => miêm
miemzf => miềm
miemzj => miệm
miemzr => miểm
miemzs => miếm
miemzx => miễm
mienz => miên
mienzf => miền
mienzj => miện
mienzr => miển
mienzs => miến
mienzx => miễn
miengz => miêng
miengzf => miềng
miengzj => miệng
miengzr => miểng
miengzs => miếng
miengzx => miễng
mienhzj => miệnh
mienhzs => miếnh
miepzj => miệp
mietzj => miệt
mietzs => miết
mieuz => miêu
mieuzf => miều
mieuzj => miệu
mieuzr => miểu
mieuzs => miếu
mieuzx => miễu
mim => mim
mimf => mìm
mimj => mịm
mimr => mỉm
mims => mím
mimx => mĩm
min => min
minf => mìn
minj => mịn
minr => mỉn
mins => mín
minx => mĩn
ming => ming
mingf => mìng
mingr => mỉng
minh => minh
minhf => mình
minhj => mịnh
minhr => mỉnh
minhs => mính
minhx => mĩnh
mipj => mịp
mips => míp
mitj => mịt
mits => mít
miu => miu
miur => mỉu
mius => míu
mo => mo
mof => mò
moj => mọ
mor => mỏ
mos => mó
mow => mơ
mowf => mờ
mowj => mợ
mowr => mở
mows => mớ
mowx => mỡ
mox => mõ
moz => mô
mozf => mồ
mozj => mộ
mozr => mổ
mozs => mố
mozx => mỗ
moa => moa
moaj => mọa
moas => móa
moacwj => moặc
moai => moai
moaix => moãi
moan => moan
moanw => moăn
moang => moang
moangs => moáng
moay => moay
mocj => mọc
mocs => móc
mocws => mớc
moczj => mộc
moczs => mốc
moe => moe
moes => móe
moen => moen
moi => moi
moif => mòi
moij => mọi
moir => mỏi
mois => mói
moiw => mơi
moiwf => mời
moiwj => mợi
moiwr => mởi
moiws => mới
moiwx => mỡi
moix => mõi
moiz => môi
moizf => mồi
moizj => mội
moizr => mổi
moizs => mối
moizx => mỗi
mom => mom
momf => mòm
momr => mỏm
moms => móm
momw => mơm
momwf => mờm
momwr => mởm
momws => mớm
momx => mõm
momz => môm
momzf => mồm
momzr => mổm
momzs => mốm
mon => mon
monf => mòn
monj => mọn
monr => mỏn
mons => món
monw => mơn
monwf => mờn
monwr => mởn
monws => mớn
monwx => mỡn
monx => mõn
monz => môn
monzf => mồn
monzj => mộn
monzr => mổn
monzs => mốn
mong => mong
mongf => mòng
mongj => mọng
mongr => mỏng
mongs => móng
mongw => mơng
mongwj => mợng
mongz => mông
mongzf => mồng
mongzj => mộng
mongzr => mổng
mongzs => mống
mongzx => mỗng
monh => monh
monhr => mỏnh
moo => moo
moof => mòo
moos => móo
moocj => moọc
moocs => moóc
moom => moom
moon => moon
moong => moong
moongf => moòng
mopj => mọp
mops => móp
mopws => mớp
mopzs => mốp
motj => mọt
mots => mót
motws => mớt
motzj => một
motzs => mốt
mu => mu
muf => mù
muj => mụ
mur => mủ
mus => mú
muw => mư
muwf => mừ
muwj => mự
muwr => mử
muws => mứ
mux => mũ
mua => mua
muaf => mùa
muaj => mụa
muar => mủa
muas => múa
muaw => mưa
muawf => mừa
muawr => mửa
muaws => mứa
muawx => mữa
muax => mũa
muanz => muân
muayz => muây
mucj => mục
mucs => múc
mucwj => mực
mucws => mức
muchj => mụch
mui => mui
muif => mùi
muij => mụi
muir => mủi
muis => múi
muix => mũi
mum => mum
mumr => mủm
mums => múm
mumw => mưm
mumx => mũm
mun => mun
munf => mùn
munj => mụn
munr => mủn
muns => mún
munw => mưn
munwf => mừn
munwj => mựn
munws => mứn
munx => mũn
mung => mung
mungf => mùng
mungj => mụng
mungr => mủng
mungw => mưng
mungwf => mừng
mungwr => mửng
mungws => mứng
mungwx => mững
mungx => mũng
munhw => mưnh
muo => muo
muowj => mượ
muowr => mưở
muocwj => mược
muocws => mước
muoczj => muộc
muoczs => muốc
muoi => muoi
muoiw => mươi
muoiwf => mười
muoiwj => mượi
muoiws => mưới
muoiwx => mưỡi
muoiz => muôi
muoizf => muồi
muoizj => muội
muoizr => muổi
muoizs => muối
muoizx => muỗi
muomwf => mườm
muomws => mướm
muomz => muôm
muomzf => muồm
muomzj => muộm
muomzs => muốm
muomzx => muỗm
muon => muon
muonw => mươn
muonwf => mườn
muonwj => mượn
muonws => mướn
muonz => muôn
muonzf => muồn
muonzj => muộn
muonzr => muổn
muonzs => muốn
muonzx => muỗn
muong => muong
muongw => mương
muongwf => mường
muongwj => mượng
muongwr => mưởng
muongws => mướng
muongz => muông
muongzf => muồng
muongzj => muộng
muongzr => muổng
muongzs => muống
muongzx => muỗng
muonhz => muônh
muopwj => mượp
muopws => mướp
muopzs => muốp
muotwj => mượt
muotws => mướt
muotzj => muột
muotzs => muốt
muouwj => mượu
muouwx => mưỡu
mupj => mụp
mups => múp
mutj => mụt
muts => mút
mutwj => mựt
mutws => mứt
muuw => mưu
muuwr => mửu
muuws => mứu
muy => muy
muys => múy
muya => muya
muyng => muyng
my => my
myf => mỳ
myj => mỵ
myr => mỷ
mys => mý
myx => mỹ
na => na
naf => nà
naj => nạ
nar => nả
nas => ná
naw => nă
nawf => nằ
nawj => nặ
naws => nắ
nax => nã
naz => nâ
nacj => nạc
nacs => nác
nacwj => nặc
nacws => nắc
naczs => nấc
nachs => nách
nai => nai
naif => nài
naij => nại
nair => nải
nais => nái
naix => nãi
nam => nam
namf => nàm
namj => nạm
nams => nám
namw => năm
namwf => nằm
namwj => nặm
namwr => nẳm
namws => nắm
namwx => nẵm
namx => nãm
namz => nâm
namzf => nầm
namzj => nậm
namzr => nẩm
namzs => nấm
namzx => nẫm
nan => nan
nanf => nàn
nanj => nạn
nanr => nản
nans => nán
nanw => năn
nanwf => nằn
nanwj => nặn
nanwr => nẳn
nanws => nắn
nanwx => nẵn
nanx => nãn
nanz => nân
nanzf => nần
nanzj => nận
nanzr => nẩn
nanzs => nấn
nanzx => nẫn
nang => nang
nangf => nàng
nangj => nạng
nangr => nảng
nangs => náng
nangw => năng
nangwf => nằng
nangwj => nặng
nangwr => nẳng
nangws => nắng
nangwx => nẵng
nangx => nãng
nangz => nâng
nangzf => nầng
nangzj => nậng
nangzr => nẩng
nangzs => nấng
nangzx => nẫng
nanh => nanh
nanhf => nành
nanhj => nạnh
nanhs => nánh
nao => nao
naof => nào
naoj => nạo
naor => nảo
naos => náo
naox => não
napj => nạp
naps => náp
napwj => nặp
napws => nắp
napzj => nập
napzs => nấp
natj => nạt
nats => nát
natwj => nặt
natws => nắt
natzj => nật
natzs => nất
nau => nau
nauf => nàu
naur => nảu
naus => náu
nauz => nâu
nauzf => nầu
nauzj => nậu
nauzr => nẩu
nauzs => nấu
nauzx => nẫu
nay => nay
nayf => này
nayj => nạy
nayr => nảy
nays => náy
nayx => nãy
nayz => nây
nayzf => nầy
nayzj => nậy
nayzr => nẩy
nayzs => nấy
nayzx => nẫy
ne => ne
nef => nè
nej => nẹ
ner => nẻ
nes => né
nez => nê
nezf => nề
nezj => nệ
nezr => nể
nezs => nế
nezx => nễ
necj => nẹc
necs => néc
neczs => nếc
nechzs => nếch
nem => nem
nemf => nèm
nemj => nẹm
nems => ném
nemz => nêm
nemzf => nềm
nemzj => nệm
nemzs => nếm
nen => nen
nenf => nèn
nenj => nẹn
nens => nén
nenz => nên
nenzf => nền
nenzj => nện
nenzr => nển
nenzs => nến
neng => neng
nengf => nèng
nengs => néng
nengz => nêng
nenhz => nênh
nenhzf => nềnh
nenhzj => nệnh
nenhzs => nếnh
neo => neo
neof => nèo
neoj => nẹo
neor => nẻo
neos => néo
neox => nẽo
nepj => nẹp
neps => nép
nepzj => nệp
nepzs => nếp
netj => nẹt
nets => nét
netzs => nết
neuz => nêu
neuzf => nều
neuzj => nệu
neuzr => nểu
neuzs => nếu
neuzx => nễu
nga => nga
ngaf => ngà
ngaj => ngạ
ngar => ngả
ngas => ngá
ngaw => ngă
ngawf => ngằ
ngaws => ngắ
ngax => ngã
ngaz => ngâ
ngacj => ngạc
ngacs => ngác
ngacwj => ngặc
ngacws => ngắc
ngaczs => ngấc
ngachj => ngạch
ngachs => ngách
ngai => ngai
ngaif => ngài
ngaij => ngại
ngair => ngải
ngais => ngái
ngaix => ngãi
ngam => ngam
ngamf => ngàm
ngamj => ngạm
ngams => ngám
ngamw => ngăm
ngamwf => ngằm
ngamwj => ngặm
ngamwr => ngẳm
ngamws => ngắm
ngamz => ngâm
ngamzf => ngầm
ngamzj => ngậm
ngamzr => ngẩm
ngamzs => ngấm
ngamzx => ngẫm
ngan => ngan
nganf => ngàn
nganj => ngạn
nganr => ngản
ngans => ngán
nganw => ngăn
nganwf => ngằn
nganwj => ngặn
nganwr => ngẳn
nganws => ngắn
nganwx => ngẵn
nganx => ngãn
nganz => ngân
nganzf => ngần
nganzj => ngận
nganzr => ngẩn
nganzs => ngấn
nganzx => ngẫn
ngang => ngang
ngangf => ngàng
ngangr => ngảng
ngangs => ngáng
ngangw => ngăng
ngangwf => ngằng
ngangwj => ngặng
ngangwr => ngẳng
ngangx => ngãng
ngangz => ngâng
ngangzf => ngầng
ngangzj => ngậng
ngangzr => ngẩng
ngangzx => ngẫng
nganh => nganh
nganhf => ngành
nganhj => ngạnh
nganhr => ngảnh
nganhs => ngánh
nganhx => ngãnh
ngao => ngao
ngaof => ngào
ngaoj => ngạo
ngaor => ngảo
ngaos => ngáo
ngaox => ngão
ngapj => ngạp
ngaps => ngáp
ngapwj => ngặp
ngapws => ngắp
ngapzj => ngập
ngapzs => ngấp
ngatj => ngạt
ngats => ngát
ngatwj => ngặt
ngatws => ngắt
ngatzj => ngật
ngatzs => ngất
ngau => ngau
ngauf => ngàu
ngauj => ngạu
ngaus => ngáu
ngauz => ngâu
ngauzf => ngầu
ngauzj => ngậu
ngauzr => ngẩu
ngauzs => ngấu
ngauzx => ngẫu
ngay => ngay
ngayf => ngày
ngayj => ngạy
ngayr => ngảy
ngays => ngáy
ngayx => ngãy
ngayz => ngây
ngayzf => ngầy
ngayzj => ngậy
ngayzr => ngẩy
ngayzs => ngấy
ngayzx => ngẫy
nge => nge
nges => ngé
ngez => ngê
ngezf => ngề
ngezj => ngệ
ngezx => ngễ
ngechzj => ngệch
ngechzs => ngếch
ngen => ngen
ngenf => ngèn
ngenj => ngẹn
ngenr => ngẻn
ngens => ngén
ngenx => ngẽn
ngenz => ngên
ngenzj => ngện
ngenzr => ngển
ngenhz => ngênh
ngenhzj => ngệnh
ngenhzx => ngễnh
ngeo => ngeo
ngeof => ngèo
ngeoj => ngẹo
ngeor => ngẻo
ngeos => ngéo
ngeox => ngẽo
ngetj => ngẹt
ngets => ngét
ngeuz => ngêu
nghaf => nghà
nghar => nghả
nghax => nghã
nghacj => nghạc
nghacs => nghác
nghachj => nghạch
nghachs => nghách
nghaix => nghãi
nghamws => nghắm
nghamzx => nghẫm
nghanf => nghàn
nghanx => nghãn
nghanz => nghân
nghangf => nghàng
nghanh => nghanh
nghanhf => nghành
nghanhj => nghạnh
nghaof => nghào
nghaoj => nghạo
nghaos => ngháo
nghapzj => nghập
nghatj => nghạt
nghatwj => nghặt
nghau => nghau
nghe => nghe
nghef => nghè
nghej => nghẹ
ngher => nghẻ
nghes => nghé
nghex => nghẽ
nghez => nghê
nghezf => nghề
nghezj => nghệ
nghezr => nghể
nghezs => nghế
nghezx => nghễ
ngheczj => nghệc
nghechzj => nghệch
nghechzs => nghếch
nghems => nghém
nghemz => nghêm
nghemzj => nghệm
nghemzx => nghễm
nghen => nghen
nghenf => nghèn
nghenj => nghẹn
nghenr => nghẻn
nghens => nghén
nghenx => nghẽn
nghenz => nghên
nghenzj => nghện
nghenzr => nghển
nghenzs => nghến
nghenzx => nghễn
ngheng => ngheng
nghengf => nghèng
nghengz => nghêng
nghengzx => nghễng
nghenhz => nghênh
nghenhzf => nghềnh
nghenhzr => nghểnh
nghenhzx => nghễnh
ngheo => ngheo
ngheof => nghèo
ngheoj => nghẹo
ngheor => nghẻo
ngheos => nghéo
ngheox => nghẽo
nghepj => nghẹp
ngheps => nghép
nghepzj => nghệp
nghetj => nghẹt
nghets => nghét
nghetzj => nghệt
ngheuz => nghêu
ngheuzf => nghều
ngheuzj => nghệu
ngheuzr => nghểu
ngheuzx => nghễu
nghi => nghi
nghif => nghì
nghij => nghị
nghir => nghỉ
nghis => nghí
nghix => nghĩ
nghia => nghia
nghiaj => nghịa
nghiar => nghỉa
nghias => nghía
nghiax => nghĩa
nghicj => nghịc
nghichj => nghịch
nghichs => nghích
nghieczs => nghiếc
nghiemz => nghiêm
nghiemzf => nghiềm
nghiemzj => nghiệm
nghiemzr => nghiểm
nghiemzs => nghiếm
nghiemzx => nghiễm
nghienz => nghiên
nghienzf => nghiền
nghienzj => nghiện
nghienzr => nghiển
nghienzs => nghiến
nghienzx => nghiễn
nghiengz => nghiêng
nghiengzf => nghiềng
nghienhz => nghiênh
nghiepzj => nghiệp
nghiepzs => nghiếp
nghietzj => nghiệt
nghietzs => nghiết
nghieuz => nghiêu
nghieuzf => nghiều
nghieuzj => nghiệu
nghim => nghim
nghimr => nghỉm
nghin => nghin
nghinf => nghìn
nghinr => nghỉn
nghins => nghín
nghing => nghing
nghingx => nghĩng
nghinh => nghinh
nghinhj => nghịnh
nghinhr => nghỉnh
nghinhx => nghĩnh
nghips => nghíp
nghitj => nghịt
nghits => nghít
nghiuf => nghìu
nghiuj => nghịu
nghiur => nghỉu
nghius => nghíu
nghos => nghó
nghowf => nghờ
nghoanhr => nghoảnh
nghocs => nghóc
nghoe => nghoe
nghoef => nghòe
nghoes => nghóe
nghoeof => nghoèo
nghoeor => nghoẻo
nghoeos => nghoéo
nghoiw => nghơi
nghoiwj => nghợi
nghoiwx => nghỡi
nghoms => nghóm
nghomwj => nghợm
nghongs => nghóng
nghots => nghót
nghur => nghủ
nghuw => nghư
nghuwx => nghữ
nghux => nghũ
nghuechzj => nghuệch
nghuenz => nghuên
nghungwf => nghừng
nghungwx => nghững
nghuoiwf => nghười
nghuongwx => nghưỡng
nghuts => nghút
nghuy => nghuy
nghuyenz => nghuyên
nghuyenzj => nghuyện
nghuyetzj => nghuyệt
ngi => ngi
ngij => ngị
ngir => ngỉ
ngix => ngĩ
ngias => ngía
ngiax => ngĩa
ngichj => ngịch
ngiemz => ngiêm
ngiemzf => ngiềm
ngiemzj => ngiệm
ngienz => ngiên
ngienzj => ngiện
ngienzs => ngiến
ngiengz => ngiêng
ngiepzj => ngiệp
ngietzj => ngiệt
ngieuzf => ngiều
ngimr => ngỉm
ngin => ngin
nginf => ngìn
nginhf => ngình
nginhx => ngĩnh
ngitj => ngịt
ngiu => ngiu
ngiuj => ngịu
ngiur => ngỉu
ngo => ngo
ngof => ngò
ngoj => ngọ
ngor => ngỏ
ngos => ngó
ngow => ngơ
ngowf => ngờ
ngowj => ngợ
ngowr => ngở
ngows => ngớ
ngowx => ngỡ
ngox => ngõ
ngoz => ngô
ngozf => ngồ
ngozj => ngộ
ngozr => ngổ
ngozs => ngố
ngozx => ngỗ
ngoa => ngoa
ngoaf => ngòa
ngoaj => ngọa
ngoar => ngỏa
ngoas => ngóa
ngoax => ngõa
ngoacj => ngoạc
ngoacs => ngoác
ngoacwj => ngoặc
ngoacws => ngoắc
ngoachj => ngoạch
ngoachs => ngoách
ngoai => ngoai
ngoaif => ngoài
ngoaij => ngoại
ngoair => ngoải
ngoais => ngoái
ngoaix => ngoãi
ngoamf => ngoàm
ngoamj => ngoạm
ngoamwj => ngoặm
ngoamws => ngoắm
ngoamx => ngoãm
ngoan => ngoan
ngoanf => ngoàn
ngoanj => ngoạn
ngoanr => ngoản
ngoans => ngoán
ngoanwf => ngoằn
ngoanws => ngoắn
ngoanx => ngoãn
ngoang => ngoang
ngoangf => ngoàng
ngoangj => ngoạng
ngoangr => ngoảng
ngoangw => ngoăng
ngoangwf => ngoằng
ngoangwj => ngoặng
ngoangwr => ngoẳng
ngoangws => ngoắng
ngoangwx => ngoẵng
ngoangx => ngoãng
ngoanh => ngoanh
ngoanhr => ngoảnh
ngoanhx => ngoãnh
ngoao => ngoao
ngoaof => ngoào
ngoaos => ngoáo
ngoapj => ngoạp
ngoatj => ngoạt
ngoatwj => ngoặt
ngoatws => ngoắt
ngoay => ngoay
ngoayj => ngoạy
ngoayr => ngoảy
ngoays => ngoáy
ngocj => ngọc
ngocs => ngóc
ngoczj => ngộc
ngoczs => ngốc
ngoe => ngoe
ngoef => ngòe
ngoej => ngọe
ngoes => ngóe
ngoem => ngoem
ngoen => ngoen
ngoenf => ngoèn
ngoenr => ngoẻn
ngoeo => ngoeo
ngoeof => ngoèo
ngoeoj => ngoẹo
ngoeor => ngoẻo
ngoeos => ngoéo
ngoeox => ngoẽo
ngoets => ngoét
ngoi => ngoi
ngoif => ngòi
ngoij => ngọi
ngoir => ngỏi
ngois => ngói
ngoiw => ngơi
ngoiwf => ngời
ngoiwj => ngợi
ngoiwr => ngởi
ngoiws => ngới
ngoiwx => ngỡi
ngoiz => ngôi
ngoizf => ngồi
ngoizj => ngội
ngoizr => ngổi
ngoizs => ngối
ngoizx => ngỗi
ngomf => ngòm
ngomj => ngọm
ngomr => ngỏm
ngoms => ngóm
ngomw => ngơm
ngomwf => ngờm
ngomwj => ngợm
ngomwx => ngỡm
ngomz => ngôm
ngomzf => ngồm
ngomzr => ngổm
ngomzs => ngốm
ngon => ngon
ngonf => ngòn
ngonj => ngọn
ngonr => ngỏn
ngons => ngón
ngonw => ngơn
ngonws => ngớn
ngonz => ngôn
ngonzf => ngồn
ngonzj => ngộn
ngonzr => ngổn
ngonzs => ngốn
ngonzx => ngỗn
ngong => ngong
ngongf => ngòng
ngongj => ngọng
ngongr => ngỏng
ngongs => ngóng
ngongw => ngơng
ngongz => ngông
ngongzf => ngồng
ngongzr => ngổng
ngongzs => ngống
ngongzx => ngỗng
ngoong => ngoong
ngoongs => ngoóng
ngoots => ngoót
ngops => ngóp
ngopwj => ngợp
ngopws => ngớp
ngopzj => ngộp
ngopzs => ngốp
ngotj => ngọt
ngots => ngót
ngotwj => ngợt
ngotws => ngớt
ngotzj => ngột
ngotzs => ngốt
ngu => ngu
nguf => ngù
nguj => ngụ
ngur => ngủ
ngus => ngú
nguw => ngư
nguwf => ngừ
nguwj => ngự
nguwr => ngử
nguws => ngứ
nguwx => ngữ
ngux => ngũ
ngua => ngua
nguaf => ngùa
nguaj => ngụa
nguaw => ngưa
nguawf => ngừa
nguawj => ngựa
nguawr => ngửa
nguaws => ngứa
nguawx => ngữa
nguax => ngũa
nguanz => nguân
nguanzf => nguần
nguanzr => nguẩn
nguayz => nguây
nguayzf => nguầy
nguayzj => nguậy
nguayzr => nguẩy
nguayzs => nguấy
ngucj => ngục
ngucs => ngúc
ngucwj => ngực
nguechzj => nguệch
nguenz => nguên
nguenzj => nguện
nguenzx => nguễn
nguenhzf => nguềnh
nguenhzr => nguểnh
ngui => ngui
nguif => ngùi
nguij => ngụi
nguir => ngủi
nguis => ngúi
nguiw => ngưi
nguiwf => ngừi
nguiwr => ngửi
nguiwx => ngữi
nguix => ngũi
ngum => ngum
ngumf => ngùm
ngumj => ngụm
ngumr => ngủm
ngums => ngúm
ngumw => ngưm
ngumwf => ngừm
ngumwj => ngựm
ngun => ngun
ngunf => ngùn
ngunj => ngụn
ngunr => ngủn
nguns => ngún
ngunw => ngưn
ngung => ngung
ngungf => ngùng
ngungj => ngụng
ngungr => ngủng
ngungs => ngúng
ngungw => ngưng
ngungwf => ngừng
ngungwr => ngửng
ngungws => ngứng
ngungwx => ngững
nguo => nguo
nguowf => ngườ
nguowj => ngượ
nguocwj => ngược
nguocws => ngước
nguoczj => nguộc
nguoczs => nguốc
nguoi => nguoi
nguoiw => ngươi
nguoiwf => người
nguoiwj => ngượi
nguoiwr => ngưởi
nguoiws => ngưới
nguoiwx => ngưỡi
nguoiz => nguôi
nguoizf => nguồi
nguoizj => nguội
nguoizr => nguổi
nguomwf => ngườm
nguomwj => ngượm
nguon => nguon
nguonw => ngươn
nguonwf => ngườn
nguonz => nguôn
nguonzf => nguồn
nguonzj => nguộn
nguonzr => nguổn
nguonzs => nguốn
nguonzx => nguỗn
nguong => nguong
nguongw => ngương
nguongwf => ngường
nguongwj => ngượng
nguongwr => ngưởng
nguongwx => ngưỡng
nguongz => nguông
nguongzf => nguồng
nguongzs => nguống
nguongzx => nguỗng
nguotwj => ngượt
nguotzj => nguột
nguotzs => nguốt
nguouw => ngươu
nguouwf => ngườu
nguouws => ngướu
ngupj => ngụp
ngutj => ngụt
nguts => ngút
ngutws => ngứt
nguuw => ngưu
nguuwj => ngựu
nguuwr => ngửu
nguy => nguy
nguyf => ngùy
nguyj => ngụy
nguyr => ngủy
nguys => ngúy
nguychs => nguých
nguyechzj => nguyệch
nguyemz => nguyêm
nguyenz => nguyên
nguyenzf => nguyền
nguyenzj => nguyện
nguyenzr => nguyển
nguyenzs => nguyến
nguyenzx => nguyễn
nguyengzx => nguyễng
nguyetzj => nguyệt
nguyetzs => nguyết
nguyn => nguyn
nguyns => nguýn
nguyts => nguýt
ngy => ngy
ngyf => ngỳ
nha => nha
nhaf => nhà
nhaj => nhạ
nhar => nhả
nhas => nhá
nhaw => nhă
nhawf => nhằ
nhax => nhã
nhaz => nhâ
nhazj => nhậ
nhazs => nhấ
nhacj => nhạc
nhacs => nhác
nhacwj => nhặc
nhacws => nhắc
nhaczs => nhấc
nhachs => nhách
nhai => nhai
nhaif => nhài
nhaij => nhại
nhair => nhải
nhais => nhái
nhaix => nhãi
nhaizj => nhậi
nhaizs => nhấi
nham => nham
nhamf => nhàm
nhamj => nhạm
nhamr => nhảm
nhams => nhám
nhamw => nhăm
nhamwf => nhằm
nhamwj => nhặm
nhamwr => nhẳm
nhamws => nhắm
nhamwx => nhẵm
nhamx => nhãm
nhamz => nhâm
nhamzf => nhầm
nhamzj => nhậm
nhamzr => nhẩm
nhamzs => nhấm
nhamzx => nhẫm
nhan => nhan
nhanf => nhàn
nhanj => nhạn
nhanr => nhản
nhans => nhán
nhanw => nhăn
nhanwf => nhằn
nhanwj => nhặn
nhanwr => nhẳn
nhanws => nhắn
nhanwx => nhẵn
nhanx => nhãn
nhanz => nhân
nhanzf => nhần
nhanzj => nhận
nhanzr => nhẩn
nhanzs => nhấn
nhanzx => nhẫn
nhang => nhang
nhangf => nhàng
nhangj => nhạng
nhangr => nhảng
nhangs => nháng
nhangw => nhăng
nhangwf => nhằng
nhangwj => nhặng
nhangwr => nhẳng
nhangws => nhắng
nhangwx => nhẵng
nhangx => nhãng
nhangz => nhâng
nhangzf => nhầng
nhangzx => nhẫng
nhanh => nhanh
nhanhf => nhành
nhanhj => nhạnh
nhanhr => nhảnh
nhanhs => nhánh
nhanhwj => nhặnh
nhanhz => nhânh
nhao => nhao
nhaof => nhào
nhaoj => nhạo
nhaor => nhảo
nhaos => nháo
nhaox => nhão
nhaozj => nhạô
nhaozs => nháô
nhapj => nhạp
nhaps => nháp
nhapwj => nhặp
nhapws => nhắp
nhapzj => nhập
nhapzs => nhấp
nhatj => nhạt
nhats => nhát
nhatwj => nhặt
nhatws => nhắt
nhatzj => nhật
nhatzs => nhất
nhau => nhau
nhauf => nhàu
nhauj => nhạu
nhaur => nhảu
nhaus => nháu
nhaux => nhãu
nhauz => nhâu
nhauzf => nhầu
nhauzj => nhậu
nhauzr => nhẩu
nhauzx => nhẫu
nhay => nhay
nhayf => nhày
nhayj => nhạy
nhayr => nhảy
nhays => nháy
nhayx => nhãy
nhayz => nhây
nhayzf => nhầy
nhayzj => nhậy
nhayzr => nhẩy
nhayzs => nhấy
nhayzx => nhẫy
nhe => nhe
nhef => nhè
nhej => nhẹ
nher => nhẻ
nhes => nhé
nhex => nhẽ
nhez => nhê
nhezf => nhề
nhezj => nhệ
nhezr => nhể
nhezs => nhế
nhezx => nhễ
nheczs => nhếc
nhechzj => nhệch
nhechzs => nhếch
nhem => nhem
nhemf => nhèm
nhemj => nhẹm
nhemr => nhẻm
nhems => nhém
nhemzj => nhệm
nhemzx => nhễm
nhen => nhen
nhenf => nhèn
nhenj => nhẹn
nhenr => nhẻn
nhens => nhén
nhenz => nhên
nhenzf => nhền
nhenzj => nhện
nheng => nheng
nhenhz => nhênh
nhenhzj => nhệnh
nhenhzs => nhếnh
nheo => nheo
nheof => nhèo
nheoj => nhẹo
nheor => nhẻo
nheos => nhéo
nheox => nhẽo
nhepj => nhẹp
nheps => nhép
nhepzs => nhếp
nhetj => nhẹt
nhets => nhét
nhetzj => nhệt
nhetzs => nhết
nheuz => nhêu
nheuzf => nhều
nheuzj => nhệu
nheuzr => nhểu
nheuzs => nhếu
nheuzx => nhễu
nhi => nhi
nhif => nhì
nhij => nhị
nhir => nhỉ
nhis => nhí
nhix => nhĩ
nhia => nhia
nhiaf => nhìa
nhiaj => nhịa
nhiar => nhỉa
nhiax => nhĩa
nhics => nhíc
nhichs => nhích
nhieczj => nhiệc
nhieczs => nhiếc
nhiemz => nhiêm
nhiemzf => nhiềm
nhiemzj => nhiệm
nhiemzr => nhiểm
nhiemzs => nhiếm
nhiemzx => nhiễm
nhienz => nhiên
nhienzf => nhiền
nhienzj => nhiện
nhienzr => nhiển
nhienzs => nhiến
nhienzx => nhiễn
nhiengz => nhiêng
nhiepzj => nhiệp
nhiepzs => nhiếp
nhietzj => nhiệt
nhietzs => nhiết
nhieuz => nhiêu
nhieuzf => nhiều
nhieuzj => nhiệu
nhieuzr => nhiểu
nhieuzs => nhiếu
nhieuzx => nhiễu
nhim => nhim
nhimf => nhìm
nhims => nhím
nhin => nhin
nhinf => nhìn
nhinj => nhịn
nhinr => nhỉn
nhins => nhín
nhinh => nhinh
nhinhf => nhình
nhinhr => nhỉnh
nhinhs => nhính
nhinhx => nhĩnh
nhipj => nhịp
nhips => nhíp
nhitj => nhịt
nhits => nhít
nhiu => nhiu
nhiuf => nhìu
nhiuj => nhịu
nhiur => nhỉu
nhius => nhíu
nho => nho
nhof => nhò
nhoj => nhọ
nhor => nhỏ
nhos => nhó
nhow => nhơ
nhowf => nhờ
nhowj => nhợ
nhowr => nhở
nhows => nhớ
nhowx => nhỡ
nhox => nhõ
nhoz => nhô
nhozf => nhồ
nhozr => nhổ
nhozs => nhố
nhozx => nhỗ
nhoa => nhoa
nhoaf => nhòa
nhoaj => nhọa
nhoar => nhỏa
nhoas => nhóa
nhoachs => nhoách
nhoai => nhoai
nhoaif => nhoài
nhoair => nhoải
nhoais => nhoái
nhoaix => nhoãi
nhoam => nhoam
nhoamf => nhoàm
nhoamj => nhoạm
nhoams => nhoám
nhoamwf => nhoằm
nhoan => nhoan
nhoanf => nhoàn
nhoanr => nhoản
nhoans => nhoán
nhoanw => nhoăn
nhoang => nhoang
nhoangf => nhoàng
nhoangj => nhoạng
nhoangr => nhoảng
nhoangs => nhoáng
nhoangwf => nhoằng
nhoangws => nhoắng
nhoanhs => nhoánh
nhoatj => nhoạt
nhoatws => nhoắt
nhoay => nhoay
nhoays => nhoáy
nhocj => nhọc
nhocs => nhóc
nhocws => nhớc
nhoczs => nhốc
nhoe => nhoe
nhoef => nhòe
nhoer => nhỏe
nhoes => nhóe
nhoex => nhõe
nhoem => nhoem
nhoen => nhoen
nhoenf => nhoèn
nhoenr => nhoẻn
nhoepj => nhoẹp
nhoetj => nhoẹt
nhoets => nhoét
nhoi => nhoi
nhoif => nhòi
nhoir => nhỏi
nhois => nhói
nhoiwf => nhời
nhoiwj => nhợi
nhoiwr => nhởi
nhoiws => nhới
nhoiz => nhôi
nhoizf => nhồi
nhoizj => nhội
nhoizr => nhổi
nhoizs => nhối
nhom => nhom
nhomf => nhòm
nhomj => nhọm
nhomr => nhỏm
nhoms => nhóm
nhomw => nhơm
nhomwf => nhờm
nhomwj => nhợm
nhomwr => nhởm
nhomws => nhớm
nhomx => nhõm
nhomz => nhôm
nhomzf => nhồm
nhomzj => nhộm
nhomzr => nhổm
nhomzs => nhốm
nhon => nhon
nhonf => nhòn
nhonj => nhọn
nhonr => nhỏn
nhons => nhón
nhonw => nhơn
nhonwf => nhờn
nhonwj => nhợn
nhonwr => nhởn
nhonws => nhớn
nhonwx => nhỡn
nhonx => nhõn
nhonz => nhôn
nhonzf => nhồn
nhonzj => nhộn
nhonzr => nhổn
nhonzs => nhốn
nhonzx => nhỗn
nhong => nhong
nhongf => nhòng
nhongr => nhỏng
nhongs => nhóng
nhongw => nhơng
nhongx => nhõng
nhongz => nhông
nhongzf => nhồng
nhongzj => nhộng
nhongzr => nhổng
nhongzs => nhống
nhongzx => nhỗng
nhoocj => nhoọc
nhoong => nhoong
nhoongj => nhoọng
nhoongs => nhoóng
nhopj => nhọp
nhops => nhóp
nhopws => nhớp
nhopzj => nhộp
nhopzs => nhốp
nhotj => nhọt
nhots => nhót
nhotwj => nhợt
nhotws => nhớt
nhotzj => nhột
nhotzs => nhốt
nhu => nhu
nhuf => nhù
nhuj => nhụ
nhur => nhủ
nhus => nhú
nhuw => như
nhuwf => nhừ
nhuwj => nhự
nhuwr => nhử
nhuws => nhứ
nhuwx => nhữ
nhux => nhũ
nhua => nhua
nhuaj => nhụa
nhuas => nhúa
nhuaw => nhưa
nhuawf => nhừa
nhuawj => nhựa
nhuaws => nhứa
nhuawx => nhữa
nhuanz => nhuân
nhuanzf => nhuần
nhuanzj => nhuận
nhuanzr => nhuẩn
nhuanzs => nhuấn
nhuanzx => nhuẫn
nhuatzj => nhuật
nhucj => nhục
nhucs => nhúc
nhucwj => nhực
nhucws => nhức
nhuez => nhuê
nhuezj => nhuệ
nhuezs => nhuế
nhuezx => nhuễ
nhuechzs => nhuếch
nhuenz => nhuên
nhui => nhui
nhuif => nhùi
nhuij => nhụi
nhuir => nhủi
nhuis => nhúi
nhuiwx => nhữi
nhuix => nhũi
nhum => nhum
nhumf => nhùm
nhumj => nhụm
nhumr => nhủm
nhums => nhúm
nhun => nhun
nhunf => nhùn
nhunr => nhủn
nhuns => nhún
nhunw => nhưn
nhunwr => nhửn
nhunwx => nhữn
nhunx => nhũn
nhung => nhung
nhungf => nhùng
nhungj => nhụng
nhungr => nhủng
nhungs => nhúng
nhungw => nhưng
nhungwf => nhừng
nhungwj => nhựng
nhungwr => nhửng
nhungws => nhứng
nhungwx => những
nhungx => nhũng
nhunhw => nhưnh
nhunhwx => nhữnh
nhuowj => nhượ
nhuowr => nhưở
nhuocwj => nhược
nhuocws => nhước
nhuoczj => nhuộc
nhuoczs => nhuốc
nhuoiwf => nhười
nhuoiwj => nhượi
nhuoizj => nhuội
nhuoizs => nhuối
nhuomwj => nhượm
nhuomz => nhuôm
nhuomzf => nhuồm
nhuomzj => nhuộm
nhuomzs => nhuốm
nhuon => nhuon
nhuonwj => nhượn
nhuonws => nhướn
nhuonz => nhuôn
nhuonzf => nhuồn
nhuonzj => nhuộn
nhuonzs => nhuốn
nhuong => nhuong
nhuongw => nhương
nhuongwf => nhường
nhuongwj => nhượng
nhuongwr => nhưởng
nhuongws => nhướng
nhuongwx => nhưỡng
nhuotzs => nhuốt
nhupj => nhụp
nhups => nhúp
nhutj => nhụt
nhuts => nhút
nhutwj => nhựt
nhutws => nhứt
nhuuw => nhưu
nhuuwf => nhừu
nhuuwx => nhữu
nhuy => nhuy
nhuyj => nhụy
nhuys => nhúy
nhuyenz => nhuyên
nhuyenzf => nhuyền
nhuyenzj => nhuyện
nhuyenzr => nhuyển
nhuyenzs => nhuyến
nhuyenzx => nhuyễn
nhuyetzs => nhuyết
nhuynj => nhuỵn
nhy => nhy
nhyr => nhỷ
nhys => nhý
nhyx => nhỹ
ni => ni
nif => nì
nij => nị
nir => nỉ
nis => ní
nix => nĩ
nia => nia
niar => nỉa
nias => nía
niax => nĩa
nics => níc
nichj => nịch
nichs => ních
nieczj => niệc
nieczs => niếc
niemz => niêm
niemzf => niềm
niemzj => niệm
niemzr => niểm
niemzs => niếm
niemzx => niễm
nienz => niên
nienzf => niền
nienzj => niện
nienzr => niển
nienzs => niến
nienzx => niễn
niengz => niêng
niengzf => niềng
niengzj => niệng
niengzr => niểng
niengzs => niếng
niengzx => niễng
niepzs => niếp
nietzj => niệt
nietzs => niết
nieuz => niêu
nieuzf => niều
nieuzj => niệu
nieuzr => niểu
nieuzs => niếu
nieuzx => niễu
nim => nim
nimf => nìm
nin => nin
ninf => nìn
ninr => nỉn
nins => nín
ning => ning
ninh => ninh
ninhf => nình
ninhj => nịnh
ninhs => nính
nips => níp
nitj => nịt
nits => nít
niu => niu
niuj => nịu
nius => níu
niux => nĩu
no => no
nof => nò
noj => nọ
nor => nỏ
nos => nó
now => nơ
nowf => nờ
nowj => nợ
nowr => nở
nows => nớ
nowx => nỡ
nox => nõ
noz => nô
nozf => nồ
nozj => nộ
nozr => nổ
nozs => nố
nozx => nỗ
noa => noa
noaf => nòa
noaj => nọa
noax => nõa
noacs => noác
noaif => noài
noaij => noại
noam => noam
noan => noan
noanf => noàn
noanj => noạn
noanr => noản
noanw => noăn
noanx => noãn
noanh => noanh
noao => noao
noats => noát
nocj => nọc
nocs => nóc
nocws => nớc
noczj => nộc
noczs => nốc
noe => noe
noes => nóe
noem => noem
noen => noen
noeng => noeng
noi => noi
noif => nòi
noij => nọi
noir => nỏi
nois => nói
noiw => nơi
noiwf => nời
noiwj => nợi
noiwr => nởi
noiws => nới
noiwx => nỡi
noix => nõi
noiz => nôi
noizf => nồi
noizj => nội
noizr => nổi
noizs => nối
noizx => nỗi
nom => nom
nomr => nỏm
noms => nóm
nomw => nơm
nomwf => nờm
nomwj => nợm
nomwr => nởm
nomws => nớm
nomwx => nỡm
nomx => nõm
nomz => nôm
nomzf => nồm
nomzj => nộm
non => non
nonf => nòn
nonj => nọn
nonr => nỏn
nons => nón
nonw => nơn
nonwj => nợn
nonx => nõn
nonz => nôn
nonzf => nồn
nonzj => nộn
nonzr => nổn
nonzx => nỗn
nong => nong
nongf => nòng
nongj => nọng
nongr => nỏng
nongs => nóng
nongx => nõng
nongz => nông
nongzf => nồng
nongzj => nộng
nongzr => nổng
nongzs => nống
nongzx => nỗng
nonh => nonh
noo => noo
noos => nóo
noocj => noọc
noocs => noóc
noom => noom
noon => noon
noong => noong
noongf => noòng
noongj => noọng
noongr => noỏng
noongs => noóng
noonh => noonh
nops => nóp
nopwj => nợp
nopws => nớp
nopzj => nộp
nopzs => nốp
notj => nọt
nots => nót
notwj => nợt
notws => nớt
notzj => nột
notzs => nốt
nu => nu
nuf => nù
nuj => nụ
nur => nủ
nus => nú
nuw => nư
nuwj => nự
nuwr => nử
nuws => nứ
nuwx => nữ
nux => nũ
nua => nua
nuaf => nùa
nuaj => nụa
nuar => nủa
nuas => núa
nuaw => nưa
nuawf => nừa
nuawj => nựa
nuawr => nửa
nuaws => nứa
nuawx => nữa
nuax => nũa
nuanzj => nuận
nucj => nục
nucs => núc
nucwj => nực
nucws => nức
nuez => nuê
nuechzs => nuếch
nui => nui
nuif => nùi
nuij => nụi
nuir => nủi
nuis => núi
nuiw => nưi
nuiws => nứi
nuix => nũi
num => num
numf => nùm
numj => nụm
nums => núm
numw => nưm
numwx => nữm
numx => nũm
nun => nun
nunf => nùn
nunj => nụn
nuns => nún
nunwx => nữn
nunx => nũn
nung => nung
nungf => nùng
nungj => nụng
nungs => núng
nungw => nưng
nungwf => nừng
nungwj => nựng
nungwx => nững
nungx => nũng
nuo => nuo
nuowj => nượ
nuows => nướ
nuocwj => nược
nuocws => nước
nuoczj => nuộc
nuoczs => nuốc
nuochws => nướch
nuoi => nuoi
nuoiw => nươi
nuoiwf => nười
nuoiws => nưới
nuoiz => nuôi
nuoizj => nuội
nuoizr => nuổi
nuoizs => nuối
nuoizx => nuỗi
nuomw => nươm
nuomwf => nườm
nuomwj => nượm
nuomws => nướm
nuomzs => nuốm
nuon => nuon
nuonw => nươn
nuonz => nuôn
nuonzf => nuồn
nuonzs => nuốn
nuong => nuong
nuongw => nương
nuongwf => nường
nuongwj => nượng
nuongws => nướng
nuongz => nuông
nuopwj => nượp
nuopws => nướp
nuotws => nướt
nuotzj => nuột
nuotzs => nuốt
nuouws => nướu
nups => núp
nuts => nút
nutws => nứt
nuuw => nưu
nuuwj => nựu
nuuws => nứu
nuuwx => nữu
nuy => nuy
nuyenz => nuyên
nuyenzj => nuyện
nuyenzx => nuyễn
nuyps => nuýp
nuyu => nuyu
ny => ny
nyf => nỳ
nyr => nỷ
nys => ný
nyx => nỹ
o => o
of => ò
oj => ọ
or => ỏ
os => ó
ow => ơ
owf => ờ
owj => ợ
owr => ở
ows => ớ
owx => ỡ
ox => õ
oz => ô
ozf => ồ
ozj => ộ
ozr => ổ
ozs => ố
ozx => ỗ
oa => oa
oaf => òa
oaj => ọa
oar => ỏa
oas => óa
oacj => oạc
oacs => oác
oacwj => oặc
oacws => oắc
oachj => oạch
oachs => oách
oai => oai
oaif => oài
oaij => oại
oair => oải
oais => oái
oaix => oãi
oam => oam
oamf => oàm
oamw => oăm
oamws => oắm
oan => oan
oanf => oàn
oanj => oạn
oanr => oản
oans => oán
oanw => oăn
oanwf => oằn
oanwj => oặn
oanwr => oẳn
oanws => oắn
oang => oang
oangf => oàng
oangr => oảng
oangw => oăng
oangwr => oẳng
oanh => oanh
oanhf => oành
oanhj => oạnh
oanhs => oánh
oao => oao
oapj => oạp
oaps => oáp
oatj => oạt
oats => oát
oatwj => oặt
oatws => oắt
ocj => ọc
ocs => óc
ocwj => ợc
ocws => ớc
oczj => ộc
oczs => ốc
ochj => ọch
ochzs => ốch
oe => oe
oej => ọe
oer => ỏe
oes => óe
oem => oem
oen => oen
oeoj => oẹo
oepj => oẹp
oeps => oép
oetj => oẹt
oets => oét
oi => oi
oif => òi
oij => ọi
oir => ỏi
ois => ói
oiw => ơi
oiwf => ời
oiwj => ợi
oiwr => ởi
oiws => ới
oix => õi
oiz => ôi
oizf => ồi
oizj => ội
oizr => ổi
oizs => ối
oizx => ỗi
om => om
omf => òm
omr => ỏm
oms => óm
omw => ơm
omwj => ợm
omwr => ởm
omws => ớm
omwx => ỡm
omx => õm
omz => ôm
omzf => ồm
omzj => ộm
omzr => ổm
omzs => ốm
omzx => ỗm
on => on
onf => òn
onj => ọn
onr => ỏn
ons => ón
onw => ơn
onwf => ờn
onwj => ợn
onwr => ởn
onws => ớn
onx => õn
onz => ôn
onzf => ồn
onzj => ộn
onzr => ổn
onzs => ốn
onzx => ỗn
ong => ong
ongf => òng
ongj => ọng
ongr => ỏng
ongs => óng
ongw => ơng
ongwf => ờng
ongwj => ợng
ongwr => ởng
ongws => ớng
ongwx => ỡng
ongx => õng
ongz => ông
ongzf => ồng
ongzj => ộng
ongzr => ổng
ongzs => ống
ongzx => ỗng
onh => onh
onhz => ônh
oo => oo
oof => òo
oocj => oọc
oocs => oóc
oom => oom
oon => oon
oong => oong
oongj => oọng
oongs => oóng
opj => ọp
ops => óp
opwj => ợp
opws => ớp
opzj => ộp
opzs => ốp
otj => ọt
ots => ót
otwj => ợt
otws => ớt
otzj => ột
otzs => ốt
pa => pa
paf => pà
paj => pạ
par => pả
pas => pá
paw => pă
pacj => pạc
pacs => pác
pacwj => pặc
pacws => pắc
paczs => pấc
pachj => pạch
pachs => pách
pachwj => pặch
pai => pai
paif => pài
paij => pại
pair => pải
pais => pái
pam => pam
pamf => pàm
pamw => păm
pamwf => pằm
pamwj => pặm
pamws => pắm
pan => pan
panf => pàn
panr => pản
pans => pán
panw => păn
panwf => pằn
panws => pắn
panz => pân
panzf => pần
pang => pang
pangf => pàng
pangj => pạng
pangr => pảng
pangs => páng
pangw => păng
pangwf => pằng
pangwr => pẳng
pangws => pắng
pangz => pâng
pangzs => pấng
panh => panh
panhf => pành
panhs => pánh
pao => pao
paof => pào
paor => pảo
paos => páo
paox => pão
paps => páp
papwj => pặp
papws => pắp
patj => pạt
pats => pát
patws => pắt
patzj => pật
patzs => pất
pau => pau
pauf => pàu
pauj => pạu
paur => pảu
paus => páu
pauz => pâu
pauzf => pầu
pauzj => pậu
pauzr => pẩu
pauzs => pấu
pay => pay
payr => pảy
pays => páy
payz => pây
payzf => pầy
payzj => pậy
payzr => pẩy
payzs => pấy
pe => pe
pef => pè
pej => pẹ
pes => pé
pez => pê
pezf => pề
pezs => pế
pecj => pẹc
pecs => péc
pechs => péch
pechzs => pếch
pem => pem
pemf => pèm
pems => pém
pemz => pêm
pen => pen
penf => pèn
penr => pẻn
pens => pén
penz => pên
peng => peng
pengf => pèng
pengr => pẻng
pengz => pêng
penh => penh
penhz => pênh
peo => peo
peof => pèo
peos => péo
peps => pép
petj => pẹt
pets => pét
petzs => pết
pha => pha
phaf => phà
phaj => phạ
phar => phả
phas => phá
phaw => phă
phax => phã
phaz => phâ
phazf => phầ
phazr => phẩ
phazs => phấ
phazx => phẫ
phacj => phạc
phacs => phác
phacwj => phặc
phacws => phắc
phaczj => phậc
phachj => phạch
phachs => phách
phai => phai
phaif => phài
phaij => phại
phair => phải
phais => phái
phaix => phãi
phaiz => phâi
phaizf => phầi
phaizr => phẩi
pham => pham
phamf => phàm
phamj => phạm
phamr => phảm
phams => phám
phamw => phăm
phamwr => phẳm
phamws => phắm
phamz => phâm
phamzf => phầm
phamzj => phậm
phamzr => phẩm
phamzs => phấm
phamzx => phẫm
phan => phan
phanf => phàn
phanj => phạn
phanr => phản
phans => phán
phanw => phăn
phanwf => phằn
phanwr => phẳn
phanws => phắn
phanx => phãn
phanz => phân
phanzf => phần
phanzj => phận
phanzr => phẩn
phanzs => phấn
phanzx => phẫn
phang => phang
phangf => phàng
phangj => phạng
phangr => phảng
phangs => pháng
phangw => phăng
phangwf => phằng
phangwr => phẳng
phangws => phắng
phangz => phâng
phangzr => phẩng
phanh => phanh
phanhf => phành
phanhr => phảnh
phanhs => phánh
phao => phao
phaof => phào
phaor => phảo
phaos => pháo
phapj => phạp
phaps => pháp
phapwj => phặp
phapzj => phập
phapzs => phấp
phatj => phạt
phats => phát
phatwj => phặt
phatws => phắt
phatzj => phật
phatzs => phất
phau => phau
phauf => phàu
phaur => phảu
phaus => pháu
phaux => phãu
phauz => phâu
phauzf => phầu
phauzj => phậu
phauzr => phẩu
phauzs => phấu
phauzx => phẫu
phay => phay
phayf => phày
phayj => phạy
phayr => phảy
phays => pháy
phayz => phây
phayzf => phầy
phayzj => phậy
phayzr => phẩy
phayzs => phấy
phe => phe
phef => phè
phej => phẹ
pher => phẻ
phes => phé
phez => phê
phezf => phề
phezj => phệ
phezr => phể
phezs => phế
phecj => phẹc
phecs => phéc
phechzj => phệch
phechzs => phếch
phem => phem
phemf => phèm
phems => phém
phemzf => phềm
phen => phen
phenf => phèn
phenj => phẹn
phens => phén
phenz => phên
phenzf => phền
phenzj => phện
phenzr => phển
phenzs => phến
pheng => pheng
phengf => phèng
phengr => phẻng
phengs => phéng
phengz => phêng
phenh => phenh
phenhs => phénh
phenhz => phênh
phenhzf => phềnh
phenhzs => phếnh
phenhzx => phễnh
pheo => pheo
pheof => phèo
pheor => phẻo
pheos => phéo
pheps => phép
phepzs => phếp
phetj => phẹt
phets => phét
phetzj => phệt
phetzs => phết
pheuzf => phều
pheuzr => phểu
pheuzs => phếu
pheuzx => phễu
phi => phi
phif => phì
phij => phị
phir => phỉ
phis => phí
phia => phia
phiaf => phìa
phiaj => phịa
phiar => phỉa
phias => phía
phics => phíc
phichj => phịch
phichs => phích
phieczs => phiếc
phiemz => phiêm
phiemzf => phiềm
phiemzj => phiệm
phiemzs => phiếm
phiemzx => phiễm
phienz => phiên
phienzf => phiền
phienzj => phiện
phienzr => phiển
phienzs => phiến
phienzx => phiễn
phiengz => phiêng
phiengzf => phiềng
phiengzs => phiếng
phiepzs => phiếp
phietzj => phiệt
phietzs => phiết
phieuz => phiêu
phieuzf => phiều
phieuzj => phiệu
phieuzr => phiểu
phieuzs => phiếu
phieuzx => phiễu
phim => phim
phimf => phìm
phimj => phịm
phims => phím
phin => phin
phinf => phìn
phinj => phịn
phinr => phỉn
phins => phín
phing => phing
phingf => phìng
phinh => phinh
phinhf => phình
phinhr => phỉnh
phinhs => phính
phips => phíp
phitj => phịt
phits => phít
phiu => phiu
phiuj => phịu
pho => pho
phof => phò
phoj => phọ
phor => phỏ
phos => phó
phow => phơ
phowf => phờ
phowr => phở
phows => phớ
phoz => phô
phozf => phồ
phozr => phổ
phozs => phố
phozx => phỗ
phoa => phoa
phoas => phóa
phoais => phoái
phoangf => phoàng
phoanh => phoanh
phocj => phọc
phocs => phóc
phocws => phớc
phoczj => phộc
phoczs => phốc
phoi => phoi
phoif => phòi
phoir => phỏi
phois => phói
phoiw => phơi
phoiwf => phời
phoiwr => phởi
phoiws => phới
phoiz => phôi
phoizf => phồi
phoizr => phổi
phoizs => phối
phoizx => phỗi
phom => phom
phomf => phòm
phomr => phỏm
phoms => phóm
phomw => phơm
phomz => phôm
phomzr => phổm
phon => phon
phonf => phòn
phonj => phọn
phonr => phỏn
phons => phón
phonw => phơn
phonwf => phờn
phonwr => phởn
phonws => phớn
phonwx => phỡn
phonz => phôn
phonzf => phồn
phonzx => phỗn
phong => phong
phongf => phòng
phongj => phọng
phongr => phỏng
phongs => phóng
phongw => phơng
phongwf => phờng
phongws => phớng
phongz => phông
phongzf => phồng
phongzj => phộng
phongzr => phổng
phongzs => phống
phongzx => phỗng
phonh => phonh
phonhf => phònh
phonhz => phônh
phoo => phoo
phoocj => phoọc
phoocs => phoóc
phoong => phoong
phoongf => phoòng
phoongs => phoóng
phops => phóp
phopwj => phợp
phopzj => phộp
phopzs => phốp
photj => phọt
phots => phót
photws => phớt
photzs => phốt
phu => phu
phuf => phù
phuj => phụ
phur => phủ
phus => phú
phuw => phư
phuwf => phừ
phuwj => phự
phuwr => phử
phuws => phứ
phuwx => phữ
phux => phũ
phua => phua
phuaf => phùa
phuaw => phưa
phuawf => phừa
phuaws => phứa
phuazx => phũâ
phuanzj => phuận
phuanzx => phuẫn
phuatzj => phuật
phucj => phục
phucs => phúc
phucwj => phực
phucws => phức
phui => phui
phuif => phùi
phuir => phủi
phuis => phúi
phum => phum
phumf => phùm
phumj => phụm
phums => phúm
phun => phun
phunf => phùn
phunj => phụn
phunr => phủn
phuns => phún
phunw => phưn
phung => phung
phungf => phùng
phungj => phụng
phungr => phủng
phungs => phúng
phungw => phưng
phungwf => phừng
phungws => phứng
phungx => phũng
phuowf => phườ
phuocwj => phược
phuocws => phước
phuoczj => phuộc
phuoczs => phuốc
phuoiw => phươi
phuoizs => phuối
phuon => phuon
phuonw => phươn
phuonwf => phườn
phuonwj => phượn
phuonws => phướn
phuonwx => phưỡn
phuonz => phuôn
phuong => phuong
phuongw => phương
phuongwf => phường
phuongwj => phượng
phuongwr => phưởng
phuongws => phướng
phuongwx => phưỡng
phuongz => phuông
phuongzs => phuống
phuotwj => phượt
phuotws => phướt
phupj => phụp
phups => phúp
phupwj => phựp
phutj => phụt
phuts => phút
phutwj => phựt
phutws => phứt
phuuw => phưu
phuy => phuy
phuyf => phùy
phuyr => phủy
phuys => phúy
phuya => phuya
phuyenz => phuyên
phuyetzs => phuyết
phuynh => phuynh
phy => phy
phys => phý
pi => pi
pif => pì
pir => pỉ
pis => pí
pia => pia
piaj => pịa
pias => pía
picj => pịc
pics => píc
pichj => pịch
pichs => pích
pieczs => piếc
piemzf => piềm
pienz => piên
pienzf => piền
pienzs => piến
piengz => piêng
piengzf => piềng
piengzj => piệng
piengzs => piếng
pietzj => piệt
pietzs => piết
pieuz => piêu
pieuzs => piếu
pim => pim
pims => pím
pin => pin
pinf => pìn
pins => pín
ping => ping
pinh => pinh
pinhf => pình
pinhr => pỉnh
pinhs => pính
pips => píp
pits => pít
piu => piu
piuf => pìu
pius => píu
po => po
pof => pò
poj => pọ
por => pỏ
pos => pó
pow => pơ
powf => pờ
powr => pở
pows => pớ
poz => pô
pozf => pồ
pozj => pộ
pozs => pố
poa => poa
poangw => poăng
poats => poát
pocs => póc
pocws => pớc
poczj => pộc
poczs => pốc
poe => poe
poem => poem
poi => poi
poir => pỏi
poiw => pơi
poiwf => pời
poiws => pới
poiz => pôi
poizf => pồi
poizs => pối
pom => pom
pomj => pọm
pomr => pỏm
poms => póm
pomz => pôm
pon => pon
ponf => pòn
ponw => pơn
ponz => pôn
ponzf => pồn
ponzr => pổn
ponzs => pốn
pong => pong
pongf => pòng
pongj => pọng
pongr => pỏng
pongs => póng
pongw => pơng
pongz => pông
pongzf => pồng
pongzj => pộng
pongzs => pống
ponh => ponh
ponhw => pơnh
ponhz => pônh
poo => poo
poocj => poọc
poocs => poóc
poom => poom
poon => poon
poong => poong
poongf => poòng
poongj => poọng
poongs => poóng
popzj => pộp
popzs => pốp
pots => pót
potws => pớt
potzs => pốt
pu => pu
puf => pù
puj => pụ
pur => pủ
pus => pú
puw => pư
puwf => pừ
puwr => pử
puws => pứ
pua => pua
puaf => pùa
puar => pủa
puas => púa
puaw => pưa
puaws => pứa
puanz => puân
puatzj => puật
pucj => pục
pucs => púc
pucwj => pực
puchs => púch
pui => pui
pum => pum
pumf => pùm
pums => púm
pun => pun
punf => pùn
puns => pún
punw => pưn
punwf => pừn
pung => pung
pungf => pùng
pungj => pụng
pungr => pủng
pungs => púng
pungw => pưng
pungws => pứng
punh => punh
puo => puo
puowf => pườ
puocws => pước
puoczs => puốc
puoiw => pươi
puoiz => puôi
puoizf => puồi
puonwj => pượn
puonws => pướn
puonz => puôn
puonzs => puốn
puongw => pương
puongwf => pường
puongz => puông
puongzf => puồng
pupj => pụp
pups => púp
putj => pụt
puts => pút
putwj => pựt
putws => pứt
puy => puy
puya => puya
puyu => puyu
py => py
pyr => pỷ
qua => qua
quaf => quà
quaj => quạ
quar => quả
quas => quá
quaw => quă
quax => quã
quaz => quâ
quazj => quậ
quazr => quẩ
quazs => quấ
quazx => quẫ
quacj => quạc
quacs => quác
quacwj => quặc
quacws => quắc
quaczs => quấc
quachj => quạch
quachs => quách
quachwj => quặch
quai => quai
quaif => quài
quaij => quại
quair => quải
quais => quái
quam => quam
quams => quám
quamw => quăm
quamwf => quằm
quamwj => quặm
quamws => quắm
quamz => quâm
quan => quan
quanf => quàn
quanj => quạn
quanr => quản
quans => quán
quanw => quăn
quanwf => quằn
quanwj => quặn
quanws => quắn
quanz => quân
quanzf => quần
quanzj => quận
quanzr => quẩn
quanzs => quấn
quanzx => quẫn
quang => quang
quangf => quàng
quangj => quạng
quangr => quảng
quangs => quáng
quangw => quăng
quangwf => quằng
quangwj => quặng
quangwr => quẳng
quangws => quắng
quangwx => quẵng
quangx => quãng
quangz => quâng
quangzf => quầng
quangzj => quậng
quanh => quanh
quanhf => quành
quanhj => quạnh
quanhr => quảnh
quanhs => quánh
quanhx => quãnh
quao => quao
quaof => quào
quaoj => quạo
quapj => quạp
quapwj => quặp
quapws => quắp
quatj => quạt
quats => quát
quatwj => quặt
quatws => quắt
quatzj => quật
quatzs => quất
quau => quau
quauf => quàu
quauj => quạu
quauzs => quấu
quay => quay
quayf => quày
quayj => quạy
quayr => quảy
quays => quáy
quayx => quãy
quayz => quây
quayzf => quầy
quayzj => quậy
quayzr => quẩy
quayzs => quấy
quayzx => quẫy
que => que
quef => què
quer => quẻ
ques => qué
quex => quẽ
quez => quê
quezf => quề
quezj => quệ
quezr => quể
quezs => quế
quechj => quẹch
quechzj => quệch
quechzs => quếch
quen => quen
quenf => quèn
quens => quén
quenz => quên
quenzf => quền
quenzj => quện
quenzr => quển
quenzs => quến
queng => queng
quenhz => quênh
quenhzf => quềnh
quenhzs => quếnh
queo => queo
queof => quèo
queoj => quẹo
queor => quẻo
queos => quéo
quetj => quẹt
quets => quét
quetzj => quệt
quetzs => quết
queuzf => quều
qui => qui
quif => quì
quij => quị
quir => quỉ
quis => quí
quix => quĩ
quia => quia
quietzs => quiết
quin => quin
quing => quing
quitj => quịt
quits => quít
quius => quíu
quo => quo
quoj => quọ
quor => quỏ
quow => quơ
quowf => quờ
quowr => quở
quows => quớ
quozj => quộ
quozs => quố
quozx => quỗ
quoacs => quoác
quoacwj => quoặc
quoaij => quoại
quoais => quoái
quoamws => quoắm
quoanw => quoăn
quoanwf => quoằn
quoangw => quoăng
quoanh => quoanh
quoatws => quoắt
quoay => quoay
quocs => quóc
quocws => quớc
quoczj => quộc
quoczs => quốc
quoetj => quoẹt
quoi => quoi
quoiw => quơi
quoiws => quới
quoizr => quổi
quoizs => quối
quon => quon
quonw => quơn
quonwf => quờn
quonwr => quởn
quonwx => quỡn
quonzf => quồn
quonzs => quốn
quongzf => quồng
quopzs => quốp
quotws => quớt
quur => quủ
quuw => quư
quuayzf => quuầy
quuayzj => quuậy
quuy => quuy
quuyenzf => quuyền
quuyetzs => quuyết
quy => quy
quyf => quỳ
quyj => quỵ
quyr => quỷ
quys => quý
quyx => quỹ
quychj => quỵch
quyenz => quyên
quyenzf => quyền
quyenzj => quyện
quyenzr => quyển
quyenzs => quyến
quyenzx => quyễn
quyengz => quyêng
quyenhzf => quyềnh
quyetzj => quyệt
quyetzs => quyết
quyn => quyn
quynf => quỳn
quyngf => quỳng
quynh => quynh
quynhf => quỳnh
quynhj => quỵnh
quynhr => quỷnh
quynhs => quýnh
quytj => quỵt
quyts => quýt
ra => ra
raf => rà
raj => rạ
rar => rả
ras => rá
raw => ră
rawf => rằ
raws => rắ
rax => rã
razr => rẩ
razs => rấ
racj => rạc
racs => rác
racwj => rặc
racws => rắc
raczj => rậc
raczs => rấc
rachj => rạch
rachs => rách
rai => rai
raif => rài
raij => rại
rair => rải
rais => rái
raix => rãi
ram => ram
ramf => ràm
ramj => rạm
ramr => rảm
rams => rám
ramw => răm
ramwf => rằm
ramwj => rặm
ramws => rắm
ramz => râm
ramzf => rầm
ramzj => rậm
ramzr => rẩm
ramzs => rấm
ramzx => rẫm
ran => ran
ranf => ràn
ranj => rạn
rans => rán
ranw => răn
ranwf => rằn
ranwj => rặn
ranwr => rẳn
ranws => rắn
ranwx => rẵn
ranx => rãn
ranz => rân
ranzf => rần
ranzj => rận
ranzs => rấn
rang => rang
rangf => ràng
rangj => rạng
rangr => rảng
rangs => ráng
rangw => răng
rangwf => rằng
rangwj => rặng
rangwr => rẳng
rangws => rắng
rangwx => rẵng
rangx => rãng
rangz => râng
rangzf => rầng
ranh => ranh
ranhf => rành
ranhj => rạnh
ranhr => rảnh
ranhs => ránh
ranhw => rănh
ranhws => rắnh
ranhx => rãnh
rao => rao
raof => rào
raoj => rạo
raor => rảo
raos => ráo
raox => rão
rapj => rạp
raps => ráp
rapwj => rặp
rapws => rắp
rapzj => rập
rapzs => rấp
ratj => rạt
rats => rát
ratwj => rặt
ratws => rắt
ratzj => rật
ratzs => rất
rau => rau
rauf => ràu
raur => rảu
raus => ráu
rauz => râu
rauzf => rầu
rauzj => rậu
rauzr => rẩu
rauzx => rẫu
ray => ray
rayf => rày
rayj => rạy
rayr => rảy
rays => ráy
rayx => rãy
rayz => rây
rayzf => rầy
rayzr => rẩy
rayzs => rấy
rayzx => rẫy
re => re
ref => rè
rej => rẹ
rer => rẻ
res => ré
rex => rẽ
rez => rê
rezf => rề
rezj => rệ
rezr => rể
rezs => rế
rezx => rễ
recj => rẹc
recs => réc
reczs => rếc
rechs => réch
rechzs => rếch
rem => rem
remf => rèm
remj => rẹm
remx => rẽm
remz => rêm
ren => ren
renf => rèn
renr => rẻn
rens => rén
renz => rên
renzf => rền
renzj => rện
renzs => rến
reng => reng
rengf => rèng
rengr => rẻng
rengz => rêng
renhz => rênh
renhzf => rềnh
renhzr => rểnh
reo => reo
reof => rèo
reor => rẻo
reos => réo
repj => rẹp
reps => rép
repzj => rệp
repzs => rếp
retj => rẹt
rets => rét
retzj => rệt
retzs => rết
reuz => rêu
reuzf => rều
reuzj => rệu
reuzs => rếu
reuzx => rễu
ri => ri
rif => rì
rij => rị
rir => rỉ
ris => rí
rix => rĩ
ria => ria
riaf => rìa
riaj => rịa
riar => rỉa
rias => ría
riax => rĩa
rics => ríc
richj => rịch
richs => rích
rieczj => riệc
rieczs => riếc
riemz => riêm
riemzf => riềm
riemzj => riệm
riemzr => riểm
rienz => riên
rienzf => riền
rienzj => riện
rienzr => riển
rienzs => riến
rienzx => riễn
riengz => riêng
riengzf => riềng
riengzj => riệng
riengzr => riểng
riengzs => riếng
riepzj => riệp
riepzs => riếp
rietzj => riệt
rietzs => riết
rieuz => riêu
rieuzf => riều
rieuzj => riệu
rieuzs => riếu
rieuzx => riễu
rim => rim
rimj => rịm
rimr => rỉm
rims => rím
rin => rin
rinf => rìn
rinj => rịn
rins => rín
ring => ring
ringf => rìng
rinh => rinh
rinhf => rình
rinhj => rịnh
rinhr => rỉnh
rinhs => rính
ripj => rịp
rips => ríp
ritj => rịt
rits => rít
riu => riu
riuf => rìu
riuj => rịu
rius => ríu
riux => rĩu
ro => ro
rof => rò
roj => rọ
ror => rỏ
ros => ró
row => rơ
rowf => rờ
rowj => rợ
rowr => rở
rows => rớ
rowx => rỡ
rox => rõ
roz => rô
rozf => rồ
rozj => rộ
rozr => rổ
rozs => rố
rozx => rỗ
roa => roa
roaf => ròa
roas => róa
roacj => roạc
roacs => roác
roacwj => roặc
roachj => roạch
roai => roai
roaif => roài
roaiw => rơăi
roam => roam
roan => roan
roanwf => roằn
roanx => roãn
roang => roang
roangf => roàng
roangw => roăng
roangx => roãng
roanh => roanh
roanhf => roành
roapj => roạp
roatj => roạt
roats => roát
roay => roay
rocj => rọc
rocs => róc
roczj => rộc
roczs => rốc
roe => roe
roem => roem
roenf => roèn
roeng => roeng
roetj => roẹt
roets => roét
roi => roi
roif => ròi
roij => rọi
roir => rỏi
rois => rói
roiw => rơi
roiwf => rời
roiwj => rợi
roiwr => rởi
roiws => rới
roix => rõi
roiz => rôi
roizf => rồi
roizj => rội
roizr => rổi
roizs => rối
roizx => rỗi
rom => rom
romf => ròm
romj => rọm
romr => rỏm
roms => róm
romw => rơm
romwf => rờm
romwj => rợm
romwr => rởm
romws => rớm
romwx => rỡm
romx => rõm
romz => rôm
romzf => rồm
romzj => rộm
romzr => rổm
romzs => rốm
ron => ron
ronf => ròn
ronj => rọn
ronr => rỏn
rons => rón
ronw => rơn
ronwf => rờn
ronwj => rợn
ronwr => rởn
ronws => rớn
ronwx => rỡn
ronz => rôn
ronzf => rồn
ronzj => rộn
ronzr => rổn
ronzs => rốn
ronzx => rỗn
rong => rong
rongf => ròng
rongj => rọng
rongr => rỏng
rongs => róng
rongw => rơng
rongwf => rờng
rongx => rõng
rongz => rông
rongzf => rồng
rongzj => rộng
rongzr => rổng
rongzs => rống
rongzx => rỗng
roo => roo
roocs => roóc
room => room
roomj => roọm
roon => roon
roonf => roòn
roong => roong
roongf => roòng
roongs => roóng
ropj => rọp
ropwj => rợp
ropws => rớp
ropzj => rộp
ropzs => rốp
rotj => rọt
rots => rót
rotws => rớt
rotzj => rột
rotzs => rốt
ru => ru
ruf => rù
ruj => rụ
rur => rủ
rus => rú
ruw => rư
ruwf => rừ
ruwj => rự
ruwr => rử
ruws => rứ
ruwx => rữ
rux => rũ
rua => rua
ruaf => rùa
ruaj => rụa
ruar => rủa
ruas => rúa
ruaw => rưa
ruawf => rừa
ruawj => rựa
ruawr => rửa
ruaws => rứa
ruawx => rữa
ruax => rũa
ruanz => ruân
ruanzf => ruần
ruanzs => ruấn
ruanzx => ruẫn
rucj => rục
rucs => rúc
rucwj => rực
rucws => rức
ruchj => rụch
ruchws => rứch
ruez => ruê
ruezj => ruệ
ruezs => ruế
rui => rui
ruif => rùi
ruij => rụi
ruir => rủi
ruis => rúi
ruiw => rưi
ruix => rũi
rum => rum
rumf => rùm
rumj => rụm
rumr => rủm
rums => rúm
rumw => rưm
run => run
runf => rùn
runj => rụn
runr => rủn
runs => rún
runw => rưn
runwf => rừn
runx => rũn
rung => rung
rungf => rùng
rungj => rụng
rungr => rủng
rungs => rúng
rungw => rưng
rungwf => rừng
rungwj => rựng
rungwr => rửng
rungws => rứng
rungx => rũng
runh => runh
ruo => ruo
ruocwj => rược
ruocws => rước
ruoczj => ruộc
ruoczs => ruốc
ruoiw => rươi
ruoiwf => rười
ruoiwj => rượi
ruoiwr => rưởi
ruoiws => rưới
ruoiwx => rưỡi
ruoiz => ruôi
ruoizf => ruồi
ruoizj => ruội
ruoizr => ruổi
ruoizs => ruối
ruoizx => ruỗi
ruomw => rươm
ruomwf => rườm
ruomwj => rượm
ruomws => rướm
ruomzj => ruộm
ruonw => rươn
ruonwf => rườn
ruonws => rướn
ruonwx => rưỡn
ruonzf => ruồn
ruong => ruong
ruongw => rương
ruongwf => rường
ruongwj => rượng
ruongwr => rưởng
ruongws => rướng
ruongz => ruông
ruongzf => ruồng
ruongzj => ruộng
ruongzr => ruổng
ruongzs => ruống
ruongzx => ruỗng
ruopwj => rượp
ruopws => rướp
ruotwj => rượt
ruotws => rướt
ruotzj => ruột
ruotzs => ruốt
ruou => ruou
ruouw => rươu
ruouwf => rườu
ruouwj => rượu
rupj => rụp
rups => rúp
rutj => rụt
ruts => rút
rutws => rứt
ruuwf => rừu
ruuwj => rựu
ruy => ruy
ruyenz => ruyên
ruyenzf => ruyền
ruyenzj => ruyện
ruyenzs => ruyến
ruyetzj => ruyệt
ry => ry
ryf => rỳ
ryj => rỵ
ryr => rỷ
rys => rý
ryx => rỹ
sa => sa
saf => sà
saj => sạ
sar => sả
sas => sá
saw => să
saws => sắ
sawx => sẵ
sax => sã
saz => sâ
sazs => sấ
sacj => sạc
sacs => sác
sacwj => sặc
sacws => sắc
saczs => sấc
sachj => sạch
sachs => sách
sai => sai
saif => sài
saij => sại
sair => sải
sais => sái
saix => sãi
sam => sam
samf => sàm
samj => sạm
samr => sảm
sams => sám
samw => săm
samwf => sằm
samwr => sẳm
samws => sắm
samwx => sẵm
samx => sãm
samz => sâm
samzf => sầm
samzj => sậm
samzr => sẩm
samzs => sấm
samzx => sẫm
san => san
sanf => sàn
sanj => sạn
sanr => sản
sans => sán
sanw => săn
sanwf => sằn
sanwj => sặn
sanwr => sẳn
sanws => sắn
sanwx => sẵn
sanx => sãn
sanz => sân
sanzf => sần
sanzj => sận
sanzr => sẩn
sanzs => sấn
sanzx => sẫn
sang => sang
sangf => sàng
sangj => sạng
sangr => sảng
sangs => sáng
sangw => săng
sangwf => sằng
sangwj => sặng
sangwr => sẳng
sangws => sắng
sangwx => sẵng
sangx => sãng
sangz => sâng
sangzf => sầng
sanh => sanh
sanhf => sành
sanhj => sạnh
sanhr => sảnh
sanhs => sánh
sanhw => sănh
sanhws => sắnh
sanhx => sãnh
sao => sao
saof => sào
saoj => sạo
saor => sảo
saos => sáo
saox => são
saoz => saô
sapj => sạp
saps => sáp
sapwj => sặp
sapws => sắp
sapzj => sập
sapzs => sấp
satj => sạt
sats => sát
satwj => sặt
satws => sắt
satzj => sật
satzs => sất
sau => sau
sauf => sàu
sauj => sạu
saur => sảu
saus => sáu
sauz => sâu
sauzf => sầu
sauzj => sậu
sauzr => sẩu
sauzs => sấu
sauzx => sẫu
say => say
sayf => sày
sayj => sạy
sayr => sảy
says => sáy
sayz => sây
sayzf => sầy
sayzj => sậy
sayzr => sẩy
sayzs => sấy
se => se
sef => sè
sej => sẹ
ser => sẻ
ses => sé
sex => sẽ
sez => sê
sezf => sề
sezj => sệ
sezr => sể
sezs => sế
sezx => sễ
secj => sẹc
secs => séc
sechs => séch
sechzj => sệch
sechzs => sếch
sem => sem
semj => sẹm
semr => sẻm
sems => sém
semz => sêm
sen => sen
senf => sèn
senr => sẻn
sens => sén
senz => sên
senzf => sền
senzj => sện
senzr => sển
senzs => sến
seng => seng
sengf => sèng
sengr => sẻng
sengs => séng
sengz => sêng
senhf => sènh
senhz => sênh
senhzf => sềnh
senhzj => sệnh
senhzr => sểnh
senhzs => sếnh
seo => seo
seof => sèo
seoj => sẹo
seor => sẻo
seos => séo
seox => sẽo
sepj => sẹp
seps => sép
sepzj => sệp
sepzs => sếp
setj => sẹt
sets => sét
setzj => sệt
setzs => sết
seuz => sêu
seuzf => sều
seuzj => sệu
seuzr => sểu
seuzs => sếu
si => si
sif => sì
sij => sị
sir => sỉ
sis => sí
six => sĩ
sia => sia
siaf => sìa
siaj => sịa
siar => sỉa
sias => sía
sics => síc
sichj => sịch
sichs => sích
sieczs => siếc
siemz => siêm
siemzr => siểm
siemzx => siễm
sienz => siên
sienzf => siền
sienzs => siến
sienzx => siễn
siengz => siêng
siengzr => siểng
siepzj => siệp
siepzs => siếp
sietzj => siệt
sietzs => siết
sieuz => siêu
sieuzf => siều
sieuzj => siệu
sieuzr => siểu
sieuzs => siếu
sieuzx => siễu
sim => sim
simf => sìm
sims => sím
sin => sin
sinf => sìn
sinj => sịn
sinr => sỉn
sins => sín
sing => sing
sinh => sinh
sinhf => sình
sinhj => sịnh
sinhr => sỉnh
sinhs => sính
sinhx => sĩnh
sipj => sịp
sips => síp
sitj => sịt
sits => sít
siu => siu
siuf => sìu
siuj => sịu
siur => sỉu
sius => síu
siux => sĩu
so => so
sof => sò
soj => sọ
sor => sỏ
sos => só
sow => sơ
sowf => sờ
sowj => sợ
sowr => sở
sows => sớ
sowx => sỡ
sox => sõ
soz => sô
sozf => sồ
sozj => sộ
sozr => sổ
sozs => số
sozx => sỗ
soa => soa
soaf => sòa
soas => sóa
soax => sõa
soacj => soạc
soai => soai
soaif => soài
soaij => soại
soair => soải
soais => soái
soaix => soãi
soamf => soàm
soamj => soạm
soan => soan
soanf => soàn
soanj => soạn
soanr => soản
soans => soán
soanw => soăn
soanws => soắn
soang => soang
soangf => soàng
soangj => soạng
soangr => soảng
soangs => soáng
soanh => soanh
soapj => soạp
soatj => soạt
soats => soát
soay => soay
soays => soáy
socj => sọc
socs => sóc
socws => sớc
soczj => sộc
soczs => sốc
soe => soe
soef => sòe
soemf => soèm
soetj => soẹt
soi => soi
soif => sòi
soij => sọi
soir => sỏi
sois => sói
soiw => sơi
soiwj => sợi
soiwr => sởi
soiws => sới
soiwx => sỡi
soix => sõi
soiz => sôi
soizf => sồi
soizj => sội
soizr => sổi
soizs => sối
som => som
somf => sòm
somj => sọm
somr => sỏm
soms => sóm
somw => sơm
somwr => sởm
somws => sớm
somwx => sỡm
somz => sôm
somzr => sổm
somzs => sốm
son => son
sonf => sòn
sonj => sọn
sonr => sỏn
sons => són
sonw => sơn
sonwf => sờn
sonwj => sợn
sonwr => sởn
sonws => sớn
sonx => sõn
sonz => sôn
sonzf => sồn
sonzj => sộn
sonzs => sốn
song => song
songf => sòng
songj => sọng
songr => sỏng
songs => sóng
songw => sơng
songx => sõng
songz => sông
songzf => sồng
songzj => sộng
songzr => sổng
songzs => sống
songzx => sỗng
sonh => sonh
soo => soo
soos => sóo
soocj => soọc
soocs => soóc
soon => soon
soong => soong
soongf => soòng
soongj => soọng
soongr => soỏng
soongs => soóng
sopj => sọp
sops => sóp
sopwj => sợp
sopws => sớp
sopzj => sộp
sopzs => sốp
sotj => sọt
sots => sót
sotwj => sợt
sotws => sớt
sotzj => sột
sotzs => sốt
su => su
suf => sù
suj => sụ
sur => sủ
sus => sú
suw => sư
suwf => sừ
suwj => sự
suwr => sử
suws => sứ
suwx => sữ
sux => sũ
sua => sua
suaf => sùa
suaj => sụa
suar => sủa
suas => súa
suaw => sưa
suawf => sừa
suawj => sựa
suawr => sửa
suaws => sứa
suawx => sữa
suax => sũa
suazs => súâ
suanz => suân
suanzr => suẩn
suanzs => suấn
suatzs => suất
suayz => suây
sucj => sục
sucs => súc
sucwj => sực
sucws => sức
suez => suê
suezs => suế
sueczs => suếc
suechzs => suếch
sui => sui
suif => sùi
suij => sụi
suir => sủi
suis => súi
suiwr => sửi
suiwx => sữi
suix => sũi
sum => sum
sumf => sùm
sumj => sụm
sumw => sưm
sun => sun
sunf => sùn
sunj => sụn
sunr => sủn
suns => sún
sunw => sưn
sunwf => sừn
sung => sung
sungf => sùng
sungj => sụng
sungr => sủng
sungs => súng
sungw => sưng
sungwf => sừng
sungwj => sựng
sungwr => sửng
sungws => sứng
sungwx => sững
sungx => sũng
suo => suo
suowf => sườ
suocwj => sược
suocws => sước
suoczj => suộc
suoiw => sươi
suoiwf => sười
suoiwj => sượi
suoiwr => sưởi
suoiws => sưới
suoiwx => sưỡi
suoiz => suôi
suoizr => suổi
suoizs => suối
suoizx => suỗi
suomw => sươm
suomws => sướm
suonw => sươn
suonwf => sườn
suonwx => sưỡn
suonz => suôn
suonzr => suổn
suonzs => suốn
suong => suong
suongw => sương
suongwf => sường
suongwj => sượng
suongwr => sưởng
suongws => sướng
suongwx => sưỡng
suongz => suông
suongzf => suồng
suongzr => suổng
suongzs => suống
suotwj => sượt
suotws => sướt
suotzj => suột
suotzs => suốt
suouwj => sượu
supj => sụp
sups => súp
sutj => sụt
suts => sút
sutwj => sựt
sutws => sứt
suuw => sưu
suuwj => sựu
suuwr => sửu
suuws => sứu
suuwx => sữu
suy => suy
suyf => sùy
suyj => sụy
suys => súy
suyx => sũy
suya => suya
suyenz => suyên
suyenzf => suyền
suyenzr => suyển
suyenzs => suyến
suyenzx => suyễn
suyetzj => suyệt
suyn => suyn
suynf => suỳn
suytj => suỵt
suyts => suýt
suyu => suyu
sy => sy
syf => sỳ
syj => sỵ
syr => sỷ
sys => sý
syx => sỹ
ta => ta
taf => tà
taj => tạ
tar => tả
tas => tá
taw => tă
tawj => tặ
taws => tắ
tawx => tẵ
tax => tã
taz => tâ
tazf => tầ
tazj => tậ
tazs => tấ
tacj => tạc
tacs => tác
tacwj => tặc
tacws => tắc
taczj => tậc
taczs => tấc
tachj => tạch
tachs => tách
tai => tai
taif => tài
taij => tại
tair => tải
tais => tái
taix => tãi
tam => tam
tamf => tàm
tamj => tạm
tamr => tảm
tams => tám
tamw => tăm
tamwf => tằm
tamwj => tặm
tamwr => tẳm
tamws => tắm
tamx => tãm
tamz => tâm
tamzf => tầm
tamzj => tậm
tamzr => tẩm
tamzs => tấm
tamzx => tẫm
tan => tan
tanf => tàn
tanj => tạn
tanr => tản
tans => tán
tanw => tăn
tanwf => tằn
tanwj => tặn
tanwr => tẳn
tanws => tắn
tanx => tãn
tanz => tân
tanzf => tần
tanzj => tận
tanzr => tẩn
tanzs => tấn
tanzx => tẫn
tang => tang
tangf => tàng
tangj => tạng
tangr => tảng
tangs => táng
tangw => tăng
tangwf => tằng
tangwj => tặng
tangwr => tẳng
tangws => tắng
tangx => tãng
tangz => tâng
tangzf => tầng
tangzj => tậng
tangzr => tẩng
tangzs => tấng
tanh => tanh
tanhf => tành
tanhj => tạnh
tanhr => tảnh
tanhs => tánh
tanhw => tănh
tanhx => tãnh
tao => tao
taof => tào
taoj => tạo
taor => tảo
taos => táo
taozf => tàô
taozj => tạô
tapj => tạp
taps => táp
tapwj => tặp
tapws => tắp
tapzj => tập
tapzs => tấp
tatj => tạt
tats => tát
tatwj => tặt
tatws => tắt
tatzj => tật
tatzs => tất
tau => tau
tauf => tàu
tauj => tạu
taur => tảu
taus => táu
tauz => tâu
tauzf => tầu
tauzj => tậu
tauzr => tẩu
tauzs => tấu
tauzx => tẫu
tay => tay
tayf => tày
tayj => tạy
tayr => tảy
tays => táy
tayz => tây
tayzf => tầy
tayzj => tậy
tayzr => tẩy
tayzs => tấy
te => te
tef => tè
tej => tẹ
ter => tẻ
tes => té
tex => tẽ
tez => tê
tezf => tề
tezj => tệ
tezr => tể
tezs => tế
tezx => tễ
tecj => tẹc
tecs => téc
teczj => tệc
teczs => tếc
techzj => tệch
techzs => tếch
tem => tem
temf => tèm
temr => tẻm
tems => tém
temz => têm
ten => ten
tenf => tèn
tenj => tẹn
tenr => tẻn
tens => tén
tenx => tẽn
tenz => tên
tenzf => tền
tenzj => tện
tenzs => tến
teng => teng
tengf => tèng
tengr => tẻng
tengzf => tềng
tengzj => tệng
tengzs => tếng
tenhz => tênh
tenhzf => tềnh
tenhzj => tệnh
tenhzr => tểnh
tenhzs => tếnh
tenhzx => tễnh
teo => teo
teof => tèo
teoj => tẹo
teor => tẻo
teos => téo
teox => tẽo
tepj => tẹp
teps => tép
tepzj => tệp
tepzs => tếp
tetj => tẹt
tets => tét
tetzj => tệt
tetzs => tết
teuz => têu
teuzf => tều
teuzs => tếu
teuzx => tễu
tha => tha
thaf => thà
thaj => thạ
thar => thả
thas => thá
thawr => thẳ
thaws => thắ
thax => thã
thaz => thâ
thazf => thầ
thazj => thậ
thazs => thấ
thacj => thạc
thacs => thác
thacwj => thặc
thacws => thắc
thaczj => thậc
thaczs => thấc
thachj => thạch
thachs => thách
thachwj => thặch
thai => thai
thaif => thài
thaij => thại
thair => thải
thais => thái
thaix => thãi
tham => tham
thamf => thàm
thamj => thạm
thamr => thảm
thams => thám
thamw => thăm
thamwf => thằm
thamwr => thẳm
thamws => thắm
thamwx => thẵm
thamx => thãm
thamz => thâm
thamzf => thầm
thamzj => thậm
thamzr => thẩm
thamzs => thấm
thamzx => thẫm
than => than
thanf => thàn
thanj => thạn
thanr => thản
thans => thán
thanw => thăn
thanwf => thằn
thanwj => thặn
thanwr => thẳn
thanws => thắn
thanz => thân
thanzf => thần
thanzj => thận
thanzr => thẩn
thanzs => thấn
thanzx => thẫn
thang => thang
thangf => thàng
thangr => thảng
thangs => tháng
thangw => thăng
thangwf => thằng
thangwj => thặng
thangwr => thẳng
thangws => thắng
thangwx => thẵng
thangx => thãng
thangz => thâng
thangzf => thầng
thanh => thanh
thanhf => thành
thanhj => thạnh
thanhr => thảnh
thanhs => thánh
thanhws => thắnh
thanhx => thãnh
thanhz => thânh
thanhzf => thầnh
thao => thao
thaof => thào
thaoj => thạo
thaor => thảo
thaos => tháo
thaox => thão
thapj => thạp
thaps => tháp
thapws => thắp
thapzj => thập
thapzs => thấp
thatj => thạt
thats => thát
thatwj => thặt
thatws => thắt
thatzj => thật
thatzs => thất
thau => thau
thauj => thạu
thaur => thảu
thaus => tháu
thauz => thâu
thauzf => thầu
thauzj => thậu
thauzr => thẩu
thauzs => thấu
thauzx => thẫu
thay => thay
thayf => thày
thayr => thảy
thays => tháy
thayz => thây
thayzf => thầy
thayzj => thậy
thayzr => thẩy
thayzs => thấy
thayzx => thẫy
the => the
thef => thè
thej => thẹ
ther => thẻ
thes => thé
thex => thẽ
thez => thê
thezf => thề
thezj => thệ
thezr => thể
thezs => thế
thezx => thễ
theczs => thếc
thechzs => thếch
them => them
themf => thèm
themr => thẻm
thems => thém
themz => thêm
themzf => thềm
themzj => thệm
themzr => thểm
themzs => thếm
then => then
thenf => thèn
thenj => thẹn
thenr => thẻn
thens => thén
thenx => thẽn
thenz => thên
thenzf => thền
thenzj => thện
thenzs => thến
theng => theng
thengf => thèng
thengz => thêng
thenhz => thênh
thenhzf => thềnh
thenhzr => thểnh
thenhzs => thếnh
thenhzx => thễnh
theo => theo
theof => thèo
theoj => thẹo
theor => thẻo
theos => théo
theox => thẽo
thepj => thẹp
theps => thép
thepzj => thệp
thepzs => thếp
thetj => thẹt
thets => thét
thetzj => thệt
thetzs => thết
theuz => thêu
theuzf => thều
theuzj => thệu
theuzr => thểu
theuzs => thếu
theuzx => thễu
thi => thi
thif => thì
thij => thị
thir => thỉ
this => thí
thix => thĩ
thia => thia
thiaf => thìa
thiaj => thịa
thiar => thỉa
thias => thía
thicj => thịc
thics => thíc
thichj => thịch
thichs => thích
thieczj => thiệc
thieczs => thiếc
thiemz => thiêm
thiemzf => thiềm
thiemzj => thiệm
thiemzr => thiểm
thiemzs => thiếm
thienz => thiên
thienzf => thiền
thienzj => thiện
thienzr => thiển
thienzs => thiến
thienzx => thiễn
thiengz => thiêng
thiengzf => thiềng
thiengzj => thiệng
thiengzs => thiếng
thiepzj => thiệp
thiepzs => thiếp
thietzj => thiệt
thietzs => thiết
thieuz => thiêu
thieuzf => thiều
thieuzj => thiệu
thieuzr => thiểu
thieuzs => thiếu
thieuzx => thiễu
thim => thim
thimf => thìm
thims => thím
thin => thin
thinf => thìn
thinj => thịn
thins => thín
thing => thing
thingr => thỉng
things => thíng
thinh => thinh
thinhf => thình
thinhj => thịnh
thinhr => thỉnh
thinhs => thính
thips => thíp
thitj => thịt
thits => thít
thiu => thiu
thiuf => thìu
thiuj => thịu
thiur => thỉu
tho => tho
thof => thò
thoj => thọ
thor => thỏ
thos => thó
thow => thơ
thowf => thờ
thowj => thợ
thowr => thở
thows => thớ
thoz => thô
thozf => thồ
thozj => thộ
thozr => thổ
thozs => thố
thozx => thỗ
thoa => thoa
thoaf => thòa
thoaj => thọa
thoar => thỏa
thoas => thóa
thoax => thõa
thoacs => thoác
thoacwj => thoặc
thoachj => thoạch
thoai => thoai
thoaif => thoài
thoaij => thoại
thoair => thoải
thoais => thoái
thoaix => thoãi
thoan => thoan
thoanf => thoàn
thoanj => thoạn
thoanr => thoản
thoans => thoán
thoanw => thoăn
thoanws => thoắn
thoang => thoang
thoangf => thoàng
thoangr => thoảng
thoangs => thoáng
thoangws => thoắng
thoanh => thoanh
thoanhf => thoành
thoanhr => thoảnh
thoatj => thoạt
thoats => thoát
thoatws => thoắt
thoayj => thoạy
thoays => thoáy
thocj => thọc
thocs => thóc
thocwj => thợc
thoczj => thộc
thoczs => thốc
thoe => thoe
thoer => thỏe
thoen => thoen
thoi => thoi
thoif => thòi
thoij => thọi
thoir => thỏi
thois => thói
thoiw => thơi
thoiwf => thời
thoiwj => thợi
thoiwr => thởi
thoiws => thới
thoiz => thôi
thoizf => thồi
thoizj => thội
thoizr => thổi
thoizs => thối
thom => thom
thomf => thòm
thomj => thọm
thomr => thỏm
thoms => thóm
thomw => thơm
thomwj => thợm
thomwr => thởm
thomws => thớm
thomx => thõm
thomz => thôm
thomzf => thồm
thomzr => thổm
thomzx => thỗm
thon => thon
thonf => thòn
thonj => thọn
thonr => thỏn
thons => thón
thonw => thơn
thonwf => thờn
thonwr => thởn
thonwx => thỡn
thonz => thôn
thonzf => thồn
thonzj => thộn
thonzr => thổn
thonzs => thốn
thonzx => thỗn
thong => thong
thongf => thòng
thongj => thọng
thongr => thỏng
thongs => thóng
thongw => thơng
thongwf => thờng
thongx => thõng
thongz => thông
thongzf => thồng
thongzj => thộng
thongzr => thổng
thongzs => thống
thonhzs => thốnh
thoo => thoo
thoocs => thoóc
thoon => thoon
thoong => thoong
thoongf => thoòng
thoongj => thoọng
thoongs => thoóng
thopj => thọp
thops => thóp
thopwj => thợp
thopws => thớp
thopzj => thộp
thotj => thọt
thots => thót
thotws => thớt
thotzj => thột
thotzs => thốt
thu => thu
thuf => thù
thuj => thụ
thur => thủ
thus => thú
thuw => thư
thuwf => thừ
thuwj => thự
thuwr => thử
thuws => thứ
thuwx => thữ
thux => thũ
thua => thua
thuaf => thùa
thuar => thủa
thuaw => thưa
thuawf => thừa
thuawj => thựa
thuawr => thửa
thuaws => thứa
thuax => thũa
thuazf => thùâ
thuazj => thụâ
thuamzr => thuẩm
thuanz => thuân
thuanzf => thuần
thuanzj => thuận
thuanzr => thuẩn
thuanzs => thuấn
thuanzx => thuẫn
thuangz => thuâng
thuatzj => thuật
thuatzs => thuất
thuayzs => thuấy
thucj => thục
thucs => thúc
thucwj => thực
thucws => thức
thuez => thuê
thuezf => thuề
thuezj => thuệ
thuezr => thuể
thuezs => thuế
thuenz => thuên
thuenhzf => thuềnh
thuetzj => thuệt
thui => thui
thuif => thùi
thuij => thụi
thuir => thủi
thuis => thúi
thuiws => thứi
thuix => thũi
thum => thum
thumf => thùm
thumr => thủm
thums => thúm
thumw => thưm
thun => thun
thunf => thùn
thung => thung
thungf => thùng
thungj => thụng
thungr => thủng
thungs => thúng
thungw => thưng
thungwf => thừng
thungwj => thựng
thungwr => thửng
thungws => thứng
thungwx => thững
thungx => thũng
thuowf => thuờ
thuowj => thuợ
thuowr => thuở
thuocwj => thược
thuocws => thước
thuoczj => thuộc
thuoczs => thuốc
thuoiwf => thười
thuoiwj => thượi
thuoizf => thuồi
thuoizr => thuổi
thuoizs => thuối
thuomwj => thượm
thuomz => thuôm
thuomzj => thuộm
thuon => thuon
thuonw => thươn
thuonwf => thườn
thuonwr => thưởn
thuonwx => thưỡn
thuonz => thuôn
thuonzf => thuồn
thuonzs => thuốn
thuonzx => thuỗn
thuong => thuong
thuongw => thương
thuongwf => thường
thuongwj => thượng
thuongwr => thưởng
thuongws => thướng
thuongwx => thưỡng
thuongz => thuông
thuongzf => thuồng
thuongzj => thuộng
thuongzr => thuổng
thuongzs => thuống
thuongzx => thuỗng
thuonhw => thươnh
thuotwj => thượt
thuotws => thướt
thuotzj => thuột
thuotzs => thuốt
thupj => thụp
thutj => thụt
thuts => thút
thutwj => thựt
thuuw => thưu
thuuwj => thựu
thuuws => thứu
thuy => thuy
thuyf => thùy
thuyj => thụy
thuyr => thủy
thuys => thúy
thuya => thuya
thuyenz => thuyên
thuyenzf => thuyền
thuyenzj => thuyện
thuyenzr => thuyển
thuyenzs => thuyến
thuyetzj => thuyệt
thuyetzs => thuyết
thuyn => thuyn
thuynhf => thuỳnh
thuynhr => thuỷnh
thy => thy
thyf => thỳ
thyj => thỵ
thyr => thỷ
thys => thý
ti => ti
tif => tì
tij => tị
tir => tỉ
tis => tí
tix => tĩ
tia => tia
tiaf => tìa
tiaj => tịa
tiar => tỉa
tias => tía
tiax => tĩa
ticj => tịc
tics => tíc
tichj => tịch
tichs => tích
tieczj => tiệc
tieczs => tiếc
tiemz => tiêm
tiemzf => tiềm
tiemzj => tiệm
tiemzr => tiểm
tiemzs => tiếm
tienz => tiên
tienzf => tiền
tienzj => tiện
tienzr => tiển
tienzs => tiến
tienzx => tiễn
tiengz => tiêng
tiengzf => tiềng
tiengzj => tiệng
tiengzr => tiểng
tiengzs => tiếng
tiengzx => tiễng
tiepzj => tiệp
tiepzs => tiếp
tietzj => tiệt
tietzs => tiết
tieuz => tiêu
tieuzf => tiều
tieuzj => tiệu
tieuzr => tiểu
tieuzs => tiếu
tieuzx => tiễu
tim => tim
timf => tìm
timj => tịm
timr => tỉm
tims => tím
timx => tĩm
tin => tin
tinf => tìn
tinj => tịn
tinr => tỉn
tins => tín
tinx => tĩn
ting => ting
tingf => tìng
tingj => tịng
tingr => tỉng
tings => tíng
tinh => tinh
tinhf => tình
tinhj => tịnh
tinhr => tỉnh
tinhs => tính
tinhx => tĩnh
tipj => tịp
tips => típ
titj => tịt
tits => tít
tiu => tiu
tiuf => tìu
tiuj => tịu
tiur => tỉu
tius => tíu
tiux => tĩu
to => to
tof => tò
toj => tọ
tor => tỏ
tos => tó
tow => tơ
towf => tờ
towj => tợ
towr => tở
tows => tớ
tox => tõ
toz => tô
tozf => tồ
tozj => tộ
tozr => tổ
tozs => tố
tozx => tỗ
toa => toa
toaf => tòa
toaj => tọa
toar => tỏa
toas => tóa
toax => tõa
toacj => toạc
toacs => toác
toacwj => toặc
toachj => toạch
toachs => toách
toai => toai
toaif => toài
toaij => toại
toair => toải
toais => toái
toan => toan
toanf => toàn
toanj => toạn
toanr => toản
toans => toán
toanx => toãn
toang => toang
toangf => toàng
toangs => toáng
toanh => toanh
toanhf => toành
toanhs => toánh
toatj => toạt
toats => toát
toay => toay
toays => toáy
tocj => tọc
tocs => tóc
toczj => tộc
toczs => tốc
toe => toe
toef => tòe
toej => tọe
toes => tóe
toex => tõe
toen => toen
toenf => toèn
toetj => toẹt
toets => toét
toi => toi
toif => tòi
toij => tọi
toir => tỏi
tois => tói
toiw => tơi
toiwf => tời
toiwj => tợi
toiwr => tởi
toiws => tới
toix => tõi
toiz => tôi
toizf => tồi
toizj => tội
toizr => tổi
toizs => tối
toizx => tỗi
tom => tom
tomf => tòm
tomj => tọm
tomr => tỏm
toms => tóm
tomw => tơm
tomwj => tợm
tomwr => tởm
tomx => tõm
tomz => tôm
tomzf => tồm
tomzj => tộm
tomzr => tổm
tomzs => tốm
ton => ton
tonf => tòn
tonj => tọn
tonr => tỏn
tons => tón
tonw => tơn
tonwf => tờn
tonwj => tợn
tonwr => tởn
tonws => tớn
tonwx => tỡn
tonx => tõn
tonz => tôn
tonzf => tồn
tonzj => tộn
tonzr => tổn
tonzs => tốn
tonzx => tỗn
tong => tong
tongf => tòng
tongj => tọng
tongr => tỏng
tongs => tóng
tongw => tơng
tongwf => tờng
tongz => tông
tongzf => tồng
tongzj => tộng
tongzr => tổng
tongzs => tống
tongzx => tỗng
tonhw => tơnh
tonhwx => tỡnh
too => too
toocj => toọc
toocs => toóc
toon => toon
toong => toong
toongf => toòng
toongj => toọng
toongr => toỏng
toongs => toóng
topj => tọp
tops => tóp
topwj => tợp
topws => tớp
topzj => tộp
topzs => tốp
totj => tọt
tots => tót
totws => tớt
totzj => tột
totzs => tốt
tra => tra
traf => trà
traj => trạ
trar => trả
tras => trá
traw => tră
trax => trã
traz => trâ
trazf => trầ
trazj => trậ
tracj => trạc
tracs => trác
tracwj => trặc
tracws => trắc
traczs => trấc
trachj => trạch
trachs => trách
trai => trai
traif => trài
traij => trại
trair => trải
trais => trái
traix => trãi
traizs => trấi
tram => tram
tramf => tràm
tramj => trạm
tramr => trảm
trams => trám
tramw => trăm
tramwf => trằm
tramwj => trặm
tramws => trắm
tramx => trãm
tramz => trâm
tramzf => trầm
tramzj => trậm
tramzr => trẩm
tramzs => trấm
tramzx => trẫm
tran => tran
tranf => tràn
tranj => trạn
tranr => trản
trans => trán
tranw => trăn
tranwf => trằn
tranwj => trặn
tranws => trắn
tranz => trân
tranzf => trần
tranzj => trận
tranzr => trẩn
tranzs => trấn
tranzx => trẫn
trang => trang
trangf => tràng
trangj => trạng
trangr => trảng
trangs => tráng
trangw => trăng
trangwf => trằng
trangwj => trặng
trangwr => trẳng
trangws => trắng
trangx => trãng
trangz => trâng
trangzf => trầng
trangzj => trậng
trangzs => trấng
tranh => tranh
tranhf => trành
tranhj => trạnh
tranhr => trảnh
tranhs => tránh
tranhx => trãnh
trao => trao
traof => trào
traoj => trạo
traor => trảo
traos => tráo
traps => tráp
trapws => trắp
trapzj => trập
trapzs => trấp
tratj => trạt
trats => trát
tratwj => trặt
tratws => trắt
tratzj => trật
tratzs => trất
trau => trau
trauf => tràu
traur => trảu
traus => tráu
trauz => trâu
trauzf => trầu
trauzj => trậu
trauzr => trẩu
trauzs => trấu
trauzx => trẫu
tray => tray
trayf => trày
trayj => trạy
trayr => trảy
trayx => trãy
trayz => trây
trayzf => trầy
trayzj => trậy
trayzr => trẩy
trayzs => trấy
tre => tre
tref => trè
trej => trẹ
trer => trẻ
tres => tré
trex => trẽ
trez => trê
trezf => trề
trezj => trệ
trezr => trể
trezs => trế
trezx => trễ
trecs => tréc
trechzj => trệch
trem => trem
tremf => trèm
tremj => trẹm
tremr => trẻm
tremz => trêm
tremzx => trễm
tren => tren
trenf => trèn
trenj => trẹn
trenr => trẻn
trenx => trẽn
trenz => trên
trenzf => trền
trenzj => trện
trenzr => trển
trenzs => trến
trenzx => trễn
treng => treng
trengf => trèng
trengj => trẹng
trengs => tréng
trengz => trêng
trengzf => trềng
trenhz => trênh
trenhzf => trềnh
trenhzr => trểnh
treo => treo
treof => trèo
treoj => trẹo
treor => trẻo
treos => tréo
trepj => trẹp
tretj => trẹt
trets => trét
tretzj => trệt
tretzs => trết
treuz => trêu
treuzf => trều
treuzj => trệu
treuzs => trếu
tri => tri
trif => trì
trij => trị
trir => trỉ
tris => trí
trix => trĩ
tria => tria
triaf => trìa
triaj => trịa
triar => trỉa
trias => tría
triax => trĩa
trics => tríc
trichj => trịch
trichs => trích
trieczs => triếc
triemz => triêm
triemzf => triềm
triemzr => triểm
triemzx => triễm
trienz => triên
trienzf => triền
trienzj => triện
trienzr => triển
trienzs => triến
trienzx => triễn
triengz => triêng
triengzf => triềng
triengzj => triệng
triepzj => triệp
triepzs => triếp
trietzj => triệt
trietzs => triết
trieuz => triêu
trieuzf => triều
trieuzj => triệu
trieuzr => triểu
trieuzs => triếu
trieuzx => triễu
trim => trim
trimf => trìm
trin => trin
trinf => trìn
trinj => trịn
trinr => trỉn
trins => trín
tring => tring
tringf => trìng
trinh => trinh
trinhf => trình
trinhj => trịnh
trinhr => trỉnh
trinhs => trính
trinhx => trĩnh
tripj => trịp
trips => tríp
tritj => trịt
trits => trít
triuf => trìu
triuj => trịu
trius => tríu
triux => trĩu
tro => tro
trof => trò
troj => trọ
tror => trỏ
tros => tró
trow => trơ
trowf => trờ
trowj => trợ
trowr => trở
trows => trớ
trowx => trỡ
trox => trõ
troz => trô
trozf => trồ
trozj => trộ
trozr => trổ
trozs => trố
trozx => trỗ
troa => troa
troacj => troạc
troatj => troạt
trocj => trọc
trocs => tróc
trocws => trớc
troczs => trốc
troe => troe
troer => trỏe
troes => tróe
troetj => troẹt
troi => troi
troif => tròi
troij => trọi
troir => trỏi
trois => trói
troiw => trơi
troiwf => trời
troiwj => trợi
troiwr => trởi
troiws => trới
troiz => trôi
troizf => trồi
troizj => trội
troizr => trổi
troizs => trối
troizx => trỗi
trom => trom
tromf => tròm
tromr => trỏm
troms => tróm
tromw => trơm
tromwj => trợm
tromwr => trởm
tromx => trõm
tromz => trôm
tromzj => trộm
tromzx => trỗm
tron => tron
tronf => tròn
tronj => trọn
tronr => trỏn
trons => trón
tronw => trơn
tronwf => trờn
tronwj => trợn
tronwr => trởn
tronws => trớn
tronx => trõn
tronz => trôn
tronzf => trồn
tronzj => trộn
tronzr => trổn
tronzs => trốn
tronzx => trỗn
trong => trong
trongf => tròng
trongj => trọng
trongr => trỏng
trongs => tróng
trongw => trơng
trongwf => trờng
trongwj => trợng
trongwr => trởng
trongx => trõng
trongz => trông
trongzf => trồng
trongzj => trộng
trongzr => trổng
trongzs => trống
trongzx => trỗng
tronh => tronh
tronhf => trònh
tronhr => trỏnh
troocs => troóc
troon => troon
troong => troong
trops => tróp
tropzj => trộp
tropzs => trốp
trotj => trọt
trots => trót
trotwj => trợt
trotws => trớt
trotzs => trốt
tru => tru
truf => trù
truj => trụ
trur => trủ
trus => trú
truw => trư
truwf => trừ
truwj => trự
truwr => trử
truws => trứ
truwx => trữ
trux => trũ
trua => trua
truaf => trùa
truaj => trụa
truas => trúa
truaw => trưa
truawf => trừa
truawr => trửa
truawx => trữa
truazs => trúâ
truanz => truân
truanzf => truần
truatzj => truật
truatzs => truất
trucj => trục
trucs => trúc
trucwj => trực
trucws => trức
truez => truê
truezj => truệ
truenzf => truền
truenhzs => truếnh
trui => trui
truif => trùi
truij => trụi
truis => trúi
truix => trũi
trum => trum
trumf => trùm
trumj => trụm
trums => trúm
trun => trun
trunf => trùn
trunw => trưn
trunwf => trừn
trung => trung
trungf => trùng
trungj => trụng
trungr => trủng
trungs => trúng
trungw => trưng
trungwf => trừng
trungwj => trựng
trungws => trứng
trungwx => trững
trungx => trũng
trunh => trunh
trunhf => trùnh
truowf => trườ
truowj => trượ
truows => trướ
truocwj => trược
truocws => trước
truoczj => truộc
truoiw => trươi
truoiwf => trười
truoiws => trưới
truoiz => truôi
truoizf => truồi
truoizj => truội
truoizr => truổi
truomwf => trườm
truon => truon
truonw => trươn
truonwf => trườn
truonwr => trưởn
truonz => truôn
truong => truong
truongw => trương
truongwf => trường
truongwj => trượng
truongwr => trưởng
truongws => trướng
truongwx => trưỡng
truongz => truông
truongzf => truồng
truongzr => truổng
truonhwr => trưởnh
truotwj => trượt
truotws => trướt
truotzs => truốt
trutj => trụt
truts => trút
truuwf => trừu
truuwj => trựu
truuwr => trửu
truuws => trứu
truuwx => trữu
truy => truy
truyf => trùy
truyj => trụy
truyr => trủy
truys => trúy
truyenz => truyên
truyenzf => truyền
truyenzj => truyện
truyenzr => truyển
truyenzs => truyến
truyenzx => truyễn
truyenhzf => truyềnh
truyetzj => truyệt
truyetzs => truyết
truyps => truýp
try => try
tryr => trỷ
tu => tu
tuf => tù
tuj => tụ
tur => tủ
tus => tú
tuw => tư
tuwf => từ
tuwj => tự
tuwr => tử
tuws => tứ
tuwx => tữ
tua => tua
tuaf => tùa
tuaj => tụa
tuar => tủa
tuas => túa
tuaw => tưa
tuawf => từa
tuawj => tựa
tuawr => tửa
tuaws => tứa
tuax => tũa
tuazf => tùâ
tuazs => túâ
tuanz => tuân
tuanzf => tuần
tuanzj => tuận
tuanzr => tuẩn
tuanzs => tuấn
tuanzx => tuẫn
tuatzs => tuất
tucj => tục
tucs => túc
tucwj => tực
tucws => tức
tuez => tuê
tuezj => tuệ
tuezs => tuế
tuechzj => tuệch
tuechzs => tuếch
tuenz => tuên
tuenzr => tuển
tuenzs => tuến
tuenhz => tuênh
tuenhzf => tuềnh
tuetzs => tuết
tui => tui
tuif => tùi
tuij => tụi
tuir => tủi
tuis => túi
tuiw => tưi
tuiwf => từi
tuiwr => tửi
tuix => tũi
tum => tum
tumf => tùm
tumj => tụm
tumr => tủm
tums => túm
tun => tun
tunf => tùn
tunr => tủn
tuns => tún
tunw => tưn
tunwf => từn
tunwj => tựn
tunwr => tửn
tunws => tứn
tunx => tũn
tung => tung
tungf => tùng
tungj => tụng
tungr => tủng
tungs => túng
tungw => tưng
tungwf => từng
tungwj => tựng
tungwr => tửng
tungws => tứng
tungwx => tững
tungx => tũng
tunh => tunh
tunhs => túnh
tuo => tuo
tuowj => tượ
tuocwj => tược
tuocws => tước
tuoczj => tuộc
tuoczs => tuốc
tuoi => tuoi
tuoiw => tươi
tuoiwf => tười
tuoiwj => tượi
tuoiwr => tưởi
tuoiws => tưới
tuoiwx => tưỡi
tuoiz => tuôi
tuoizf => tuồi
tuoizj => tuội
tuoizr => tuổi
tuoizs => tuối
tuoizx => tuỗi
tuomw => tươm
tuomws => tướm
tuomz => tuôm
tuomzf => tuồm
tuonwf => tườn
tuonwj => tượn
tuonwr => tưởn
tuonws => tướn
tuonz => tuôn
tuonzf => tuồn
tuonzr => tuổn
tuonzs => tuốn
tuonzx => tuỗn
tuong => tuong
tuongw => tương
tuongwf => tường
tuongwj => tượng
tuongwr => tưởng
tuongws => tướng
tuongwx => tưỡng
tuongz => tuông
tuongzf => tuồng
tuongzj => tuộng
tuongzr => tuổng
tuongzs => tuống
tuopws => tướp
tuotwj => tượt
tuotws => tướt
tuotzj => tuột
tuotzs => tuốt
tuouw => tươu
tuouwj => tượu
tupj => tụp
tups => túp
tupws => tứp
tutj => tụt
tuts => tút
tutws => tứt
tuuw => tưu
tuuwf => từu
tuuwj => tựu
tuuwr => tửu
tuy => tuy
tuyf => tùy
tuyj => tụy
tuyr => tủy
tuys => túy
tuyx => tũy
tuya => tuya
tuyas => tuýa
tuyechzs => tuyếch
tuyemzs => tuyếm
tuyenz => tuyên
tuyenzf => tuyền
tuyenzj => tuyện
tuyenzr => tuyển
tuyenzs => tuyến
tuyenzx => tuyễn
tuyenhz => tuyênh
tuyenhzf => tuyềnh
tuyepzj => tuyệp
tuyetzj => tuyệt
tuyetzs => tuyết
tuyn => tuyn
tuynh => tuynh
tuynhs => tuýnh
tuyps => tuýp
tuyts => tuýt
tuyu => tuyu
ty => ty
tyf => tỳ
tyj => tỵ
tyr => tỷ
tys => tý
u => u
uf => ù
uj => ụ
ur => ủ
us => ú
uw => ư
uwf => ừ
uwj => ự
uwr => ử
uws => ứ
uwx => ữ
ux => ũ
ua => ua
uaf => ùa
uaj => ụa
uar => ủa
uas => úa
uaw => ưa
uawf => ừa
uawj => ựa
uawr => ửa
uaws => ứa
uawx => ữa
uax => ũa
uaz => uâ
uanz => uân
uanzf => uần
uanzj => uận
uanzr => uẩn
uanzs => uấn
uanzx => uẫn
uangz => uâng
uapzs => uấp
uatzj => uật
uatzs => uất
uayz => uây
uayzf => uầy
uayzr => uẩy
ucj => ục
ucs => úc
ucwj => ực
ucws => ức
uez => uê
uezf => uề
uezj => uệ
uezr => uể
uezs => uế
uechzs => uếch
uenz => uên
uetzs => uết
ui => ui
uif => ùi
uij => ụi
uir => ủi
uis => úi
uiw => ưi
uiwr => ửi
uix => ũi
um => um
umf => ùm
umj => ụm
umr => ủm
ums => úm
umw => ưm
umwf => ừm
umwj => ựm
un => un
unf => ùn
unj => ụn
unr => ủn
uns => ún
unw => ưn
unwf => ừn
unws => ứn
unwx => ữn
ung => ung
ungf => ùng
ungj => ụng
ungr => ủng
ungs => úng
ungw => ưng
ungwf => ừng
ungwj => ựng
ungwr => ửng
ungws => ứng
ungwx => ững
ungx => ũng
unh => unh
uo => uo
uowf => uờ
uowj => uợ
uowr => uở
uows => uớ
uocwj => ược
uocws => ước
uoczj => uộc
uoczs => uốc
uoi => uoi
uoiw => ươi
uoiwf => ười
uoiwr => ưởi
uoiws => ưới
uoiwx => ưỡi
uoiz => uôi
uoizf => uồi
uoizr => uổi
uoizs => uối
uom => uom
uomw => ươm
uomwj => ượm
uomwr => ưởm
uomws => ướm
uomwx => ưỡm
uomz => uôm
uomzf => uồm
uon => uon
uonw => ươn
uonwf => ườn
uonwj => ượn
uonwr => ưởn
uonwx => ưỡn
uonz => uôn
uonzf => uồn
uonzj => uộn
uonzr => uổn
uonzs => uốn
uong => uong
uongw => ương
uongwf => ường
uongwj => ượng
uongwr => ưởng
uongws => ướng
uongwx => ưỡng
uongz => uông
uongzf => uồng
uongzr => uổng
uongzs => uống
uongzx => uỗng
uonhz => uônh
uopws => ướp
uotwj => ượt
uotws => ướt
uotzj => uột
uotzs => uốt
uouw => ươu
uouwj => ượu
uouws => ướu
uoy => uoy
upj => ụp
ups => úp
utj => ụt
uts => út
utws => ứt
uuw => ưu
uuwj => ựu
uuwr => ửu
uuws => ứu
uuwx => ữu
uy => uy
uyf => ùy
uyj => ụy
uyr => ủy
uys => úy
uychj => uỵch
uychs => uých
uyenz => uyên
uyenzf => uyền
uyenzj => uyện
uyenzr => uyển
uyenzs => uyến
uyenzx => uyễn
uyetzj => uyệt
uyetzs => uyết
uym => uym
uyn => uyn
uynh => uynh
uynhf => uỳnh
uynhs => uýnh
uyts => uýt
va => va
vaf => và
vaj => vạ
var => vả
vas => vá
vaw => vă
vawf => vằ
vawj => vặ
vaws => vắ
vax => vã
vaz => vâ
vazf => vầ
vazj => vậ
vazs => vấ
vazx => vẫ
vacj => vạc
vacs => vác
vacwj => vặc
vacws => vắc
vaczj => vậc
vachj => vạch
vachs => vách
vachwj => vặch
vai => vai
vaif => vài
vaij => vại
vair => vải
vais => vái
vaix => vãi
vam => vam
vamf => vàm
vamj => vạm
vams => vám
vamw => văm
vamwf => vằm
vamz => vâm
vamzf => vầm
vamzj => vậm
vamzx => vẫm
van => van
vanf => vàn
vanj => vạn
vanr => vản
vans => ván
vanw => văn
vanwf => vằn
vanwj => vặn
vanwr => vẳn
vanws => vắn
vanwx => vẵn
vanx => vãn
vanz => vân
vanzf => vần
vanzj => vận
vanzr => vẩn
vanzs => vấn
vanzx => vẫn
vang => vang
vangf => vàng
vangj => vạng
vangr => vảng
vangs => váng
vangw => văng
vangwf => vằng
vangwj => vặng
vangwr => vẳng
vangws => vắng
vangwx => vẵng
vangx => vãng
vangz => vâng
vangzf => vầng
vangzj => vậng
vangzx => vẫng
vanh => vanh
vanhf => vành
vanhj => vạnh
vanhr => vảnh
vanhs => vánh
vanhx => vãnh
vao => vao
vaof => vào
vaoj => vạo
vaor => vảo
vaos => váo
vaox => vão
vapj => vạp
vaps => váp
vapwj => vặp
vapws => vắp
vapzj => vập
vapzs => vấp
vatj => vạt
vats => vát
vatwj => vặt
vatws => vắt
vatzj => vật
vatzs => vất
vauf => vàu
vaus => váu
vauz => vâu
vauzf => vầu
vauzj => vậu
vauzr => vẩu
vauzs => vấu
vauzx => vẫu
vay => vay
vayf => vày
vayj => vạy
vayr => vảy
vays => váy
vayx => vãy
vayz => vây
vayzf => vầy
vayzj => vậy
vayzr => vẩy
vayzs => vấy
vayzx => vẫy
ve => ve
vef => vè
vej => vẹ
ver => vẻ
ves => vé
vex => vẽ
vez => vê
vezf => về
vezj => vệ
vezr => vể
vezs => vế
vezx => vễ
vecj => vẹc
vecs => véc
veczj => vệc
vechzs => vếch
vem => vem
vemj => vẹm
vemzf => vềm
ven => ven
venf => vèn
venj => vẹn
venr => vẻn
vens => vén
venz => vên
venzf => vền
venzj => vện
veng => veng
vengf => vèng
vengz => vêng
venh => venh
venhz => vênh
venhzf => vềnh
venhzj => vệnh
venhzr => vểnh
venhzs => vếnh
venhzx => vễnh
veo => veo
veof => vèo
veoj => vẹo
veor => vẻo
veos => véo
vepj => vẹp
veps => vép
vetj => vẹt
vets => vét
vetzj => vệt
vetzs => vết
veuz => vêu
veuzf => vều
veuzj => vệu
veuzs => vếu
vi => vi
vif => vì
vij => vị
vir => vỉ
vis => ví
vix => vĩ
via => via
viaf => vìa
viaj => vịa
viar => vỉa
vias => vía
viax => vĩa
vics => víc
vichs => vích
vieczj => việc
vieczs => viếc
viemz => viêm
viemzf => viềm
viemzj => việm
viemzr => viểm
viemzs => viếm
viemzx => viễm
vienz => viên
vienzf => viền
vienzj => viện
vienzr => viển
vienzs => viến
vienzx => viễn
viengz => viêng
viengzf => viềng
viengzs => viếng
viengzx => viễng
viepzj => việp
viepzs => viếp
vietzj => việt
vietzs => viết
vieuz => viêu
vieuzj => việu
vieuzr => viểu
vieuzx => viễu
vim => vim
vin => vin
vinj => vịn
vins => vín
ving => ving
vinh => vinh
vinhf => vình
vinhj => vịnh
vinhr => vỉnh
vinhs => vính
vinhx => vĩnh
vips => víp
vitj => vịt
vits => vít
viu => viu
vius => víu
vo => vo
vof => vò
voj => vọ
vor => vỏ
vos => vó
vow => vơ
vowf => vờ
vowj => vợ
vowr => vở
vows => vớ
vowx => vỡ
vox => võ
voz => vô
vozf => vồ
vozj => vộ
vozr => vổ
vozs => vố
vozx => vỗ
voa => voa
voaf => vòa
voas => vóa
voax => võa
voaif => voài
voan => voan
voanw => voăn
voangf => voàng
voangj => voạng
voangs => voáng
vocj => vọc
vocs => vóc
vocwj => vợc
voczj => vộc
voczs => vốc
vochzs => vốch
voe => voe
voi => voi
voif => vòi
voij => vọi
voir => vỏi
vois => vói
voiw => vơi
voiwf => vời
voiwj => vợi
voiwr => vởi
voiws => với
voiwx => vỡi
voix => või
voiz => vôi
voizf => vồi
voizj => vội
voizs => vối
voizx => vỗi
vom => vom
vomf => vòm
vomwj => vợm
vomzf => vồm
von => von
vonf => vòn
vonj => vọn
vonr => vỏn
vons => vón
vonw => vơn
vonwf => vờn
vonwj => vợn
vonwr => vởn
vonws => vớn
vonz => vôn
vonzf => vồn
vonzj => vộn
vonzs => vốn
vonzx => vỗn
vong => vong
vongf => vòng
vongj => vọng
vongr => vỏng
vongs => vóng
vongw => vơng
vongwf => vờng
vongx => võng
vongz => vông
vongzf => vồng
vongzj => vộng
vongzr => vổng
vongzs => vống
voo => voo
voocj => voọc
voom => voom
voon => voon
voong => voong
voongf => voòng
voongs => voóng
vopj => vọp
vopws => vớp
votj => vọt
vots => vót
votwj => vợt
votws => vớt
votzj => vột
votzs => vốt
vu => vu
vuf => vù
vuj => vụ
vur => vủ
vus => vú
vuw => vư
vuwf => vừ
vuwj => vự
vuwr => vử
vuwx => vữ
vux => vũ
vua => vua
vuaf => vùa
vuaj => vụa
vuar => vủa
vuas => vúa
vuaw => vưa
vuawf => vừa
vuawj => vựa
vuawr => vửa
vuaws => vứa
vuawx => vữa
vucj => vục
vucwj => vực
vucws => vức
vueczj => vuệc
vui => vui
vuif => vùi
vuij => vụi
vuir => vủi
vuis => vúi
vuiws => vứi
vuix => vũi
vum => vum
vumf => vùm
vumx => vũm
vun => vun
vunf => vùn
vunj => vụn
vunwx => vữn
vung => vung
vungf => vùng
vungj => vụng
vungr => vủng
vungs => vúng
vungw => vưng
vungwf => vừng
vungwj => vựng
vungws => vứng
vungwx => vững
vungx => vũng
vunhf => vùnh
vuowf => vườ
vuowj => vượ
vuocwj => vược
vuocws => vước
vuoczj => vuộc
vuoiwf => vười
vuoiwj => vượi
vuoiws => vưới
vuoizx => vuỗi
vuomw => vươm
vuomwf => vườm
vuon => vuon
vuonw => vươn
vuonwf => vườn
vuonwj => vượn
vuonwr => vưởn
vuonws => vướn
vuonwx => vưỡn
vuonz => vuôn
vuonzf => vuồn
vuonzs => vuốn
vuong => vuong
vuongw => vương
vuongwf => vường
vuongwj => vượng
vuongwr => vưởng
vuongws => vướng
vuongwx => vưỡng
vuongz => vuông
vuongzf => vuồng
vuongzs => vuống
vuopws => vướp
vuotwj => vượt
vuotws => vướt
vuotzj => vuột
vuotzs => vuốt
vutj => vụt
vuts => vút
vutwj => vựt
vutws => vứt
vuuw => vưu
vuuwf => vừu
vuy => vuy
vy => vy
vyf => vỳ
vyj => vỵ
vyx => vỹ
xa => xa
xaf => xà
xaj => xạ
xar => xả
xas => xá
xaw => xă
xax => xã
xaz => xâ
xazx => xẫ
xacj => xạc
xacs => xác
xacwj => xặc
xacws => xắc
xaczs => xấc
xachj => xạch
xachs => xách
xai => xai
xaif => xài
xaij => xại
xair => xải
xais => xái
xaix => xãi
xaizs => xấi
xam => xam
xamf => xàm
xamj => xạm
xamr => xảm
xams => xám
xamw => xăm
xamwf => xằm
xamws => xắm
xamx => xãm
xamz => xâm
xamzf => xầm
xamzj => xậm
xamzr => xẩm
xamzs => xấm
xamzx => xẫm
xan => xan
xanf => xàn
xanr => xản
xans => xán
xanw => xăn
xanwr => xẳn
xanws => xắn
xanz => xân
xanzf => xần
xanzr => xẩn
xanzs => xấn
xang => xang
xangf => xàng
xangj => xạng
xangr => xảng
xangs => xáng
xangw => xăng
xangwf => xằng
xangwj => xặng
xangwr => xẳng
xangws => xắng
xangwx => xẵng
xangx => xãng
xangz => xâng
xangzx => xẫng
xanh => xanh
xanhf => xành
xanhj => xạnh
xanhr => xảnh
xanhs => xánh
xao => xao
xaof => xào
xaoj => xạo
xaor => xảo
xaos => xáo
xaox => xão
xapj => xạp
xaps => xáp
xapwj => xặp
xapws => xắp
xapzj => xập
xapzs => xấp
xatj => xạt
xats => xát
xatwj => xặt
xatws => xắt
xatzs => xất
xau => xau
xauf => xàu
xaur => xảu
xaus => xáu
xauz => xâu
xauzf => xầu
xauzj => xậu
xauzr => xẩu
xauzs => xấu
xay => xay
xayf => xày
xayr => xảy
xays => xáy
xayx => xãy
xayz => xây
xayzf => xầy
xayzj => xậy
xayzr => xẩy
xayzs => xấy
xe => xe
xef => xè
xej => xẹ
xer => xẻ
xes => xé
xex => xẽ
xez => xê
xezf => xề
xezj => xệ
xezr => xể
xezs => xế
xecj => xẹc
xecs => xéc
xechzj => xệch
xechzs => xếch
xem => xem
xemj => xẹm
xemr => xẻm
xems => xém
xemz => xêm
xen => xen
xenf => xèn
xenr => xẻn
xens => xén
xenz => xên
xenzj => xện
xeng => xeng
xengf => xèng
xengr => xẻng
xengs => xéng
xengzf => xềng
xenhz => xênh
xenhzf => xềnh
xenhzj => xệnh
xenhzr => xểnh
xenhzs => xếnh
xeo => xeo
xeof => xèo
xeoj => xẹo
xeor => xẻo
xeos => xéo
xepj => xẹp
xeps => xép
xepzj => xệp
xepzs => xếp
xetj => xẹt
xets => xét
xetzj => xệt
xetzs => xết
xeuz => xêu
xeuzj => xệu
xeuzs => xếu
xi => xi
xif => xì
xij => xị
xir => xỉ
xis => xí
xia => xia
xiaf => xìa
xiaj => xịa
xiar => xỉa
xias => xía
xics => xíc
xichj => xịch
xichs => xích
xieczj => xiệc
xieczs => xiếc
xiemz => xiêm
xiemzf => xiềm
xiemzj => xiệm
xiemzr => xiểm
xiemzs => xiếm
xienz => xiên
xienzf => xiền
xienzj => xiện
xienzr => xiển
xienzs => xiến
xiengz => xiêng
xiengzf => xiềng
xiengzr => xiểng
xiengzs => xiếng
xiengzx => xiễng
xiepzj => xiệp
xiepzs => xiếp
xietzj => xiệt
xietzs => xiết
xieuz => xiêu
xieuzf => xiều
xieuzj => xiệu
xieuzs => xiếu
xim => xim
ximf => xìm
xims => xím
xin => xin
xinf => xìn
xinj => xịn
xinr => xỉn
xins => xín
xinx => xĩn
xing => xing
xinh => xinh
xinhf => xình
xinhj => xịnh
xinhr => xỉnh
xinhs => xính
xinhx => xĩnh
xipj => xịp
xips => xíp
xitj => xịt
xits => xít
xiu => xiu
xiuf => xìu
xiuj => xịu
xiur => xỉu
xius => xíu
xo => xo
xof => xò
xoj => xọ
xor => xỏ
xos => xó
xow => xơ
xowf => xờ
xowj => xợ
xowr => xở
xows => xớ
xoz => xô
xozf => xồ
xozj => xộ
xozr => xổ
xozs => xố
xozx => xỗ
xoa => xoa
xoaf => xòa
xoaj => xọa
xoar => xỏa
xoas => xóa
xoax => xõa
xoacj => xoạc
xoacwj => xoặc
xoacws => xoắc
xoachj => xoạch
xoai => xoai
xoaif => xoài
xoair => xoải
xoais => xoái
xoaix => xoãi
xoamf => xoàm
xoamwf => xoằm
xoan => xoan
xoanf => xoàn
xoans => xoán
xoanw => xoăn
xoanwr => xoẳn
xoanws => xoắn
xoang => xoang
xoangf => xoàng
xoangj => xoạng
xoangr => xoảng
xoanh => xoanh
xoanhf => xoành
xoanhj => xoạnh
xoapj => xoạp
xoapwj => xoặp
xoatj => xoạt
xoats => xoát
xoatws => xoắt
xoay => xoay
xoayf => xoày
xoays => xoáy
xocj => xọc
xocs => xóc
xoczj => xộc
xoczs => xốc
xoe => xoe
xoef => xòe
xoej => xọe
xoes => xóe
xoen => xoen
xoenf => xoèn
xoengr => xoẻng
xoetj => xoẹt
xoets => xoét
xoi => xoi
xoir => xỏi
xois => xói
xoiw => xơi
xoiwf => xời
xoiwj => xợi
xoiwr => xởi
xoiws => xới
xoiz => xôi
xoizj => xội
xoizr => xổi
xoizs => xối
xom => xom
xomf => xòm
xomj => xọm
xomr => xỏm
xoms => xóm
xomw => xơm
xomwf => xờm
xomwr => xởm
xomws => xớm
xomz => xôm
xomzf => xồm
xomzj => xộm
xomzr => xổm
xomzs => xốm
xon => xon
xonf => xòn
xonj => xọn
xonr => xỏn
xons => xón
xonw => xơn
xonwf => xờn
xonwr => xởn
xonws => xớn
xonz => xôn
xonzf => xồn
xonzj => xộn
xonzs => xốn
xong => xong
xongf => xòng
xongr => xỏng
xongs => xóng
xongx => xõng
xongz => xông
xongzf => xồng
xongzr => xổng
xongzs => xống
xoo => xoo
xoof => xòo
xoocs => xoóc
xoom => xoom
xoon => xoon
xoong => xoong
xoongf => xoòng
xoongj => xoọng
xoongr => xoỏng
xoongs => xoóng
xopj => xọp
xops => xóp
xopwj => xợp
xopzj => xộp
xopzs => xốp
xotj => xọt
xots => xót
xotwj => xợt
xotws => xớt
xotzj => xột
xotzs => xốt
xu => xu
xuf => xù
xuj => xụ
xur => xủ
xus => xú
xuw => xư
xuwf => xừ
xuwj => xự
xuwr => xử
xuws => xứ
xuwx => xữ
xua => xua
xuaf => xùa
xuaj => xụa
xuar => xủa
xuas => xúa
xuaw => xưa
xuawf => xừa
xuawj => xựa
xuawr => xửa
xuaws => xứa
xuawx => xữa
xuaz => xuâ
xuazj => xụâ
xuazr => xủâ
xuazs => xúâ
xuamz => xuâm
xuanz => xuân
xuanzf => xuần
xuanzj => xuận
xuanzr => xuẩn
xuanzs => xuấn
xuatzj => xuật
xuatzs => xuất
xuayzs => xuấy
xucj => xục
xucs => xúc
xucwj => xực
xucws => xức
xuchs => xúch
xuez => xuê
xuezf => xuề
xuezr => xuể
xuezs => xuế
xuechzj => xuệch
xuenz => xuên
xuenhzf => xuềnh
xui => xui
xuif => xùi
xuij => xụi
xuir => xủi
xuis => xúi
xum => xum
xumf => xùm
xumj => xụm
xumr => xủm
xums => xúm
xumw => xưm
xun => xun
xunj => xụn
xunr => xủn
xuns => xún
xung => xung
xungf => xùng
xungr => xủng
xungs => xúng
xungw => xưng
xungwf => xừng
xungwj => xựng
xungwr => xửng
xungws => xứng
xungwx => xững
xunh => xunh
xuocwj => xược
xuocws => xước
xuoczj => xuộc
xuoiwf => xười
xuoiwj => xượi
xuoiws => xưới
xuoiz => xuôi
xuoizj => xuội
xuoizs => xuối
xuomzj => xuộm
xuonwf => xườn
xuonwr => xưởn
xuonz => xuôn
xuonzs => xuốn
xuong => xuong
xuongw => xương
xuongwf => xường
xuongwj => xượng
xuongwr => xưởng
xuongws => xướng
xuongwx => xưỡng
xuongz => xuông
xuongzf => xuồng
xuongzj => xuộng
xuongzr => xuổng
xuongzs => xuống
xuongzx => xuỗng
xuopws => xướp
xuotwj => xượt
xuotws => xướt
xuotzs => xuốt
xupj => xụp
xups => xúp
xutj => xụt
xuts => xút
xutwj => xựt
xutws => xứt
xuy => xuy
xuyf => xùy
xuys => xúy
xuyeczj => xuyệc
xuyenz => xuyên
xuyenzf => xuyền
xuyenzj => xuyện
xuyenzr => xuyển
xuyenzs => xuyến
xuyenzx => xuyễn
xuyenhz => xuyênh
xuyenhzf => xuyềnh
xuyetzj => xuyệt
xuyetzs => xuyết
xuynhs => xuýnh
xuytj => xuỵt
xuyts => xuýt
xy => xy
xyf => xỳ
xyj => xỵ
xyr => xỷ
xys => xý
y => y
yf => ỳ
yj => ỵ
yr => ỷ
ys => ý
yx => ỹ
yeczs => yếc
yemz => yêm
yemzf => yềm
yemzr => yểm
yemzs => yếm
yenz => yên
yenzf => yền
yenzj => yện
yenzr => yển
yenzs => yến
yengz => yêng
yengzf => yềng
yengzr => yểng
yengzs => yếng
yetzs => yết
yeuz => yêu
yeuzf => yều
yeuzj => yệu
yeuzr => yểu
yeuzs => yếu
yeuzx => yễu
