cua|r  nguoi|wf  va|f  ^viet|zj  bi|j  o|wr  cong|z  voi|ws  tai|j  co|s
khong|z  ve|zf  ddong|zf  nam|w  ddau|zf  ^quoc|zs  ddong|zj  ^my|x  tren|z  ^ha|f
nhan|z  moi|ws  nha|f  lam|f  dduoc|wj  vi|f  hang|f  nhat|zs  gia|s  hoc|j
cac|s  vao|f  vu|j  nuoc|ws  ngay|f  tu|wf  dan|z  ^noi|zj  truong|wf  thanh|f
tang|w  dde|zr  se|x  lai|j  hoi|zj  gioi|ws  mot|zj  an|s  the|zs  la|f
chet|zs  trieu|zj  vien|z  dduong|wf  ty|r  ^nhung|wx  nghiep|zj  tinh|f  the|zr  te|zs
phat|s  hien|zj  giai|r  san|r  xuat|zs  ban|s  nu|wx  may|s  anh|r  hon|w
ddi|  ly|s  chinh|s  hinh|f  dden|zs  hanh|f  tien|zf  tre|r  thong|z  du|wj
ddien|zj  ^cong|z  ddep|j  ddoi|zs  tu|wr  bo|zj  co|w  tiep|zs  ket|zs  cau|zf
co|zr  nhung|wx  giam|r  quoc|zs  so|zs  tai|f  thuong|w  chien|zs  dda|x  len|z
su|wj  nhieu|zf  hop|wj  ddinh|j  cap|zs  tac|s  ddiem|zr  ^nguoi|wf  thu|r  bang|wf
tu|w  nhan|zj  vang|f  lon|ws  sat|s  ddat|zs  trinh|f  yeu|z  ddai|j  van|zx
truoc|ws  tuoi|zr  viec|zj  bat|ws  bao|s  chi|r  trien|zr  gai|s  hoa|s  thong|zs
mat|ws  benh|zj  cung|f  mat|wj  thang|s  thi|j  dung|j  chuc|ws  ^bo|zj  phai|r
bat|zs  bao|r  tu|wj  khach|s  ^nhat|zj  phong|f  thuc|wj  toan|f  gay|z  si|x
ddieu|zf  ddanh|s  nan|j  bo|zs  ^tong|zr  manh|j  luong|wj  ^binh|f  lich|j  tuc|j
quan|z  pham|j  truong|wr  hieu|zj  canh|r  quyet|zs  an|w  tuong|wj  luc|wj  ^ddai|j
bien|zr  lan|zf  mang|j  thoi|wf  nhap|zj  ong|z  cuoc|zj  tap|zj  thuc|ws  ^thu|r
tieu|z  qua|r  mat|zs  tau|f  ban|j  tro|wj  thu|ws  chu|r  dung|wj  ^bat|ws
^han|f  nghi|j  xay|z  cach|s  tuong|ws  hau|zj  tinh|s  tro|wr  ^thai|s  dich|j
lap|zj  ^hoi|zj  tien|z  sieu|z  dda|s  ^khong|z  cuu|ws  nghe|zj  lo|zj  pha|s
bo|r  ^quang|r  phap|s  nhu|w  ^phat|s  ^chu|r  ^nha|f  ddoi|zj  nang|w  xu|wr
tan|zs  chua|w  song|zs  chong|zf  chong|zs  bong|s  tao|j  pham|zr  trong|j  sach|s
toi|ws  ban|r  pho|zs  dien|zx  vo|wj  ca|s  ddoc|zj  phuc|j  ddao|j  phu|j
tam|z  ^tien|z  to|zs  dde|zf  ddoi|zr  me|j  tich|j  chat|zs  tran|zj  gan|zf
^tet|zs  kho|s  che|zs  giu|wx  ^mot|zj  ^hai|r  sang|s  dung|f  su|wr  thang|ws
ve|zj  be|s  giao|s  he|zj  van|w  ^ho|zf  ^bac|ws  ddang|  tri|j  nao|f
ddau|zs  ^ban|r  ddo|zj  chuyen|zj  ky|f  ky|r  vien|zj  khung|r  chuyen|zr  nong|s
xa|x  tich|s  mua|f  quyen|zf  ^trieu|zf  ^ddong|z  phi|s  tim|f  them|z  ho|zj
ten|z  can|zf  ^gia|s  ^tay|z  ^a|s  khi|s  thu|w  ^ky|f  giua|wx  khau|zr
lien|z  gia|r  ^nguyen|zx  phieu|zs  gi|f  thuat|zj  giup|s  ^dda|f  muon|zs  thuoc|zs
con|f  san|z  cuop|ws  ^giai|r  hai|j  dien|zj  tieng|zs  sac|ws  ung|ws  lua|wr
nhiem|zj  bien|zs  ^nhieu|zf  chau|z  cam|r  so|wr  ca|r  vo|z  ky|s  ^hoang|f
thoai|j  ddo|z  chung|ws  cao|s  ^can|zf  chan|z  ^vu|j  ddao|r  choi|w  tuan|zf
^dduc|ws  tinh|r  mau|zx  ddinh|f  hoat|j  noi|zr  ^cac|s  truyen|zf  nong|z  ngoai|f
loi|wj  ^thanh|f  suc|ws  mo|wr  co|z  vu|x  hoach|j  ddoan|f  ^van|w  ddo|zf
ke|zs  y|s  ngo|wf  nien|z  vong|f  ddoi|wf  tuyen|zr  ngoai|j  to|zr  o|z
ddat|j  than|zf  ^ddong|zf  than|z  le|zx  trai|s  tra|r  cuoi|zs  dau|zf  tiet|zs
binh|f  kien|zj  gap|wj  tot|zs  chuan|zr  ddem|z  ngan|z  hiem|zr  luat|zj  vung|f
^son|w  ^ngay|f  kiem|zr  hoan|f  nhac|j  ^ngoc|j  vat|zj  phat|j  ^nang|wx  bao|x
ddan|f  thuong|wf  bieu|zr  ^duong|w  ddon|s  ^thi|j  qua|s  noi|s  song|z  tu|f
dan|zx  khoan|s  dai|f  phu|r  minh|f  vi|j  gio|wf  thieu|zs  sap|ws  von|zs
vuot|wj  biet|zj  giet|zs  chay|s  noi|zj  cua|wr  phep|s  phan|zf  ke|r  ban|f
van|zs  tai|r  xuong|zs  bau|zf  ao|s  ngoi|z  tien|zs  can|s  ngheo|f  cuoi|ws
chay|j  khien|zs  ^truong|wf  hoi|zf  cu|wr  ^phap|s  nguyen|z  duc|j  van|zj  long|f
nen|z  cuong|wf  ho|zx  thue|zs  ddia|j  ^chinh|s  bi|s  tham|w  la|j  ^bao|r
trom|zj  no|wj  ^hang|f  thuy|r  thiet|zs  cuc|wj  ba|f  quan|r  ti|r  thuong|wr
to|z  toi|zj  phuong|w  ddo|r  ddoc|zs  ho|zf  vong|j  ddon|w  tai|s  ^khoi|wr
ha|j  ^chi|s  ^tang|w  thiet|zj  kien|zs  ddac|wj  ^an|zs  loai|j  tang|wj  cay|z
no|zr  ddam|z  loat|j  toi|z  ^bi|s  mien|zf  xac|s  ^nguyen|z  biet|zs  tuy|s
ddua|w  hoang|f  vuc|wj  niem|zj  lang|f  chuong|w  ^nghe|zj  ddoi|z  hon|z  cung|x
sung|s  hat|s  giam|s  ^cuoc|zj  ^phuong|w  ddang|w  ^nu|wx  ben|z  ^lien|z  huong|ws
het|zs  nganh|f  ddua|  rong|zj  quy|s  mai|j  ^ong|z  ddo|zr  lanh|x  lua|wf
lu|x  nho|r  luc|j  nhiem|zx  tuyen|zs  ddich|j  ddong|z  loi|wf  chon|j  ^co|s
^xuan|z  luu|w  cu|w  mat|zj  duoi|ws  rung|wf  ^vi|f  mac|j  lieu|zj  ^chau|z
mua|w  ^phong|f  han|j  nghiem|zj  ddang|s  lai|x  ^sai|f  so|w  ^hoa|f  ^bao|s
moi|z  tri|s  hat|j  hut|s  nang|wj  ^hon|w  that|zs  phien|z  suat|zs  ^ddo|zj
khoi|r  truc|wj  tro|f  ddong|s  nghe|zf  lay|zs  ^lam|f  khoi|wr  goi|j  nhung|w
^pho|s  phan|r  ^them|z  ^chuyen|zj  gianh|f  dday|zr  ^phu|s  ^se|x  dam|z  man|f
he|f  tham|r  nang|z  ^bi|j  ^du|wj  muc|ws  cu|x  ^gon|f  ^au|z  xang|w
mung|wf  ^dde|zf  nho|wf  ^lao|f  ^le|z  chi|s  ^bai|f  cho|wj  chuyen|z  ^khanh|s
that|zj  nhom|s  ^canh|r  co|zs  loi|zx  linh|x  huu|wx  ap|s  thoat|s  ^tu|wf
^toi|z  hoa|f  bien|z  toc|zs  ^nam|w  ^hoc|j  ^sieu|z  ^ddiem|zr  am|z  roi|w
^tau|f  ban|ws  roi|zf  bang|r  bai|f  khac|ws  ^xay|z  thien|zj  nghi|r  tong|zr
thu|wr  thao|r  thich|s  song|s  hoa|j  my|x  hang|j  de|zx  ddao|f  bai|j
troi|wf  lau|zj  phong|s  luong|w  lam|x  tung|wf  nguon|zf  ve|s  trang|ws  mau|f
ddoat|j  noi|w  ^huong|w  cam|zs  vua|wf  day|z  cho|wf  nuoi|z  ^ddang|r  ddot|zj
le|zj  ^co|z  ^tap|zj  ddau|  cai|s  ^trien|zr  xet|s  phan|z  ddat|wj  thu|s
xe|zs  toan|s  huong|wr  mau|s  ^vang|f  bac|j  chua|wx  ^tran|zf  cam|zf  ma|f
qua|f  quan|s  doa|j  thay|zs  ^hoa|s  som|ws  lop|ws  lai|s  tuong|wr  cai|r
tuyen|z  ddoi|f  thi|s  ^dan|z  liet|zj  ^thien|z  muc|j  an|zs  can|w  ^hong|zf
tin|s  ^tim|f  su|w  thien|z  dip|j  mien|zx  ^ly|s  kiem|zs  ^ddoan|f  toi|zs
cat|ws  sot|zs  banh|s  ^yen|z  kich|j  pho|s  mo|w  ^su|wj  ^the|zs  hai|f
bo|zr  tram|w  ^quan|z  nhay|r  thap|zs  ^ddieu|zf  thuc|s  mac|ws  thai|r  toa|f
nghiem|z  luan|zj  hoang|r  ^hue|zs  re|r  ^tan|z  an|zr  nghin|f  xuc|s  chap|zs
keu|z  ^le|zx  danh|f  ^ket|zs  ^vu|x  kieu|zr  ro|x  nay|f  bang|w  keo|s
chiec|zs  ^co|w  ^tai|f  xau|zs  ^ngan|z  ^ba|f  toc|s  rut|s  kich|s  huyen|zj
cho|wr  loan|j  ^chung|ws  san|f  vay|s  mac|wj  trach|s  tam|j  ^lam|z  bac|s
mo|z  me|z  sua|wx  dden|  truong|w  nhin|f  thuan|zj  ^luat|zj  nhien|z  bat|zj
phe|z  ^giam|s  toc|zj  giay|zs  khoe|r  sang|f  chiem|zs  lanh|j  thue|z  ky|x
chao|f  ^pham|j  ^may|s  ^nhan|z  uu|w  tuyet|zj  buoc|ws  ^benh|zj  so|wj  ^to|zr
khan|w  ddung|s  ^chi|r  hop|j  xuan|z  ^cach|s  nhat|zj  buc|ws  ^thong|z  ^vinh|x
^tinh|f  huy|r  tuc|ws  ddu|r  cang|f  buon|z  chinh|r  ^chay|s  ddung|ws  chat|wj
ddam|s  ^ddien|zj  thac|s  ^anh|r  ^dda|x  ^tiep|zs  ^xuat|zs  thang|wr  tac|ws  thon|z
hung|f  thieu|zj  gia|f  ^tho|w  thit|j  can|z  phan|s  nhuan|zj  ddam|r  ^ngam|ws
sat|ws  nghia|x  ddam|f  cum|s  dda|  chieu|zf  soc|zs  soat|s  san|wx  ^ddi|
quan|zf  sy|x  ^xu|wr  on|zr  kha|r  nui|s  vung|wx  dong|f  ^chua|w  mon|z
^ddinh|j  noi|zs  khac|s  tron|zs  ^ddanh|s  ddau|z  ^tam|z  khoa|s  la|s  cuoi|wf
sua|wr  ddinh|r  ^cau|zf  ^chien|zs  goc|zs  ddot|zs  ^ddau|zf  cau|z  sau|z  tang|zf
canh|s  ngu|r  duong|wx  ^bac|s  ^lo|zj  ^vo|wj  dday|zf  gui|wr  yeu|zs  tuong|w
chem|s  ngam|zf  ung|r  que|z  sach|j  tranh|s  bao|j  ^ha|j  chan|wj  ^van|z
thi|f  nho|ws  ngap|zj  thua|wf  nguc|wj  giau|f  di|j  hiep|zs  ngan|f  ^gan|zf
tran|zf  ^thuy|r  ^ky|r  phuc|s  ga|f  ^can|zj  ^bat|zs  ^dduong|wf  ^ngoai|j  goi|wj
giong|zs  dau|z  vo|wx  chuc|j  luoc|wj  cong|zj  boc|zs  dang|s  it|s  ^bien|zr
chieu|z  mai|x  ^ddinh|f  su|ws  tru|j  bong|r  uong|zs  ^be|s  gop|s  ^kiem|zr
^chuong|w  tieu|zr  ngo|zj  ^dung|x  cu|j  ^nong|z  tho|w  hap|zs  dau|zs  bao|f
chiu|j  ^tien|zs  xu|ws  phao|s  ^cuu|wj  hai|r  ^tinh|x  day|j  nhe|j  ngu|w
ma|x  ^vong|f  ^ddoi|zj  nua|wr  ^thuong|w  ca|f  cho|zx  nhiet|zj  mo|zj  trang|j
^hoan|f  luc|s  khuyen|zs  lenh|zj  chang|f  rat|zs  ddao|s  khan|zr  rac|s  buoc|zj
^thang|w  ^thieu|zs  diet|zj  gao|j  ^bang|w  chan|zs  hoi|w  cap|wj  lua|s  thay|zf
^tuan|zs  ^tien|zf  mon|s  ^truong|w  chu|s  thach|s  quang|r  ruou|wj  lac|j  ^kham|s
ddoan|j  ^thoi|wf  luoi|ws  neu|zs  ddon|zf  ddieu|zj  ^hung|w  ^hanh|f  nen|zf  ^thuc|wj
hen|j  tong|z  buyt|s  go|zx  ^giam|r  phu|s  ^co|zr  quy|x  kiem|zj  lo|zx
rieng|z  cuu|wj  khoc|s  tam|zf  ke|zr  chim|f  moi|j  nang|f  ^cap|zj  tet|zs
^giao|s  toa|r  tan|z  duong|w  ddat|ws  ^tu|wj  ^dien|zx  ^so|wr  ^bien|z  hong|zf
^nang|z  ngai|j  bai|x  nhung|x  cap|zj  ^me|j  thuyen|zf  thoa|r  trong|zf  chau|s
du|wx  ^ddai|f  huong|w  phia|s  hoa|r  san|j  roi|wf  ddap|zj  ^hiep|zj  nang|ws
uoc|ws  hon|zf  ^vo|x  ru|x  giat|zj  dde|  bo|f  phut|s  ^hau|zj  ^dde|zr
tat|zs  ngung|wf  ddoc|j  luot|wj  con|w  kho|zr  te|zj  ep|s  ^chum|f  ^phuc|s
kem|s  xep|zs  thau|zf  ^tu|w  ^lai|j  ^noi|zx  roi|zs  dung|wf  sap|zj  ddai|x
cham|zj  noi|zx  the|r  ve|r  luyen|zj  cuon|zs  chuyen|zs  ^tu|wr  om|z  kham|s
tat|zj  nguyen|zj  ^nghi|j  ^ke|r  ^thuan|zj  viet|zs  ^nuoc|ws  ^ddung|wf  chi|j  niem|zf
hanh|j  quai|s  ^quy|s  ton|zf  ^ddam|f  tui|s  se|r  khau|zs  ^ngai|x  ^thang|s
dduoi|zr  trung|s  quen|z  coc|s  moi|zx  ^bao|x  uy|r  mem|zf  ^ddao|f  hoi|r
bong|zr  ^tuyen|zr  ^tan|zs  ich|s  khuc|s  gio|s  tiec|zj  tham|zr  quyen|zs  boi|zf
buon|zf  tu|ws  ^yeu|z  am|zs  moc|zs  nga|x  ^mo|wr  ^dung|f  ^lanh|x  ddan|j
quan|zj  giac|s  xa|r  cu|ws  ^hinh|f  thang|w  van|ws  cham|j  ngu|wx  ruot|zj
ddot|wj  hop|zj  ddap|j  guong|w  ^thang|ws  canh|j  lo|wr  cham|w  nguong|wx  thep|s
hieu|zr  nguoc|wj  thu|j  huyet|zs  nhuong|wj  ^phai|r  xuyen|z  ^tri|j  lam|z  cau|zs
chieu|zs  ben|zf  cap|ws  thuoc|zj  ^ban|s  chup|j  ^phu|j  khoi|zs  khoan|r  gap|zs
kinh|s  go|wx  hiem|zs  ^huyen|zf  tang|f  ^loi|wj  ^ban|j  muu|w  ^hang|wf  o|zr
bung|j  ^tuan|zf  ngot|j  ^tam|j  san|w  ngan|w  ^van|zx  ^ngo|z  choi|zs  tac|wj
^tuyen|z  ^chuyen|zr  ro|wx  ^lich|j  ddang|wr  ^giang|s  cho|s  phoi|zs  ngan|ws  ^ddoi|zs
ao|r  tran|f  dut|ws  ^cuu|ws  tuoi|w  ^ddem|z  nhi|s  ^nhan|zj  ^kho|s  so|zr
^pha|s  mieng|zj  hoi|zs  bo|wf  chu|wx  gian|r  ^tra|f  nghien|zj  ^tho|zr  gioi|r
chuc|s  ^an|w  day|zj  tan|s  hien|zs  ^ca|f  tram|j  ^kien|z  ^hung|f  lon|wj
chot|zs  ddien|zr  nem|s  than|zj  ^thuy|s  tru|wx  da|x  kieu|zf  khan|s  co|wf
^no|zr  nua|wx  ddien|z  dan|f  ret|s  moi|zs  ^thi|s  cuc|j  huan|zs  ^hop|wj
^trong|j  khao|r  ay|zs  ^bong|s  tien|zj  ^nganh|f  ^luong|w  lang|x  lo|zf  cuong|wx
xoa|s  ham|zf  ^thu|w  cu|s  dden|f  lam|j  thu|f  ^quynh|f  khong|zr  ^ddong|zj
cham|zs  ^ngoi|z  tri|f  ^gap|wj  ^thuy|j  ^chan|z  ^ddua|w  ^sang|s  dinh|s  mo|r
^suc|ws  soc|s  ^huong|ws  ^y|s  ^quan|r  goi|s  dduoi|zs  ^gioi|ws  gan|ws  ^kien|zs
ngoi|zf  khang|wr  be|z  ^ho|zx  ^thao|r  hang|x  cat|s  ^loi|wf  uong|w  ^thuy|f
rang|j  ^tre|r  moi|wf  ^phuoc|ws  ^dich|j  ddeu|zf  tam|ws  ^thu|ws  bien|zj  tan|zj
^nhi|x  ^ddat|zs  chua|ws  mam|zf  tan|f  ^mua|f  nham|zf  nam|wf  lat|zj  trao|f
trum|f  ^mua|w  luon|z  hao|r  ^^ban|r  le|r  ^mien|zf  phan|zj  dden|zf  ^truoc|ws
^thua|wf  ^^o|z  ^dday|zr  ^ddoc|zj  tom|z  ^phan|zf  hao|f  ^trai|s  nao|x  cai|x
xay|r  na|x  hung|ws  ^thuong|wj  yet|zs  ^ve|zf  vuon|wf  thieu|z  ^ddon|s  ddap|s
nop|zj  ^luu|w  ^dden|zs  am|s  thoai|s  ^cai|s  beo|s  ^kieu|zf  ^tao|j  ^nong|s
niem|z  cang|w  tho|wr  cang|r  tiem|z  ddam|zj  ton|z  chung|s  cuong|zf  ^vuong|w
^lap|zj  thao|s  ddiep|zj  giay|f  giang|r  ^uy|r  tu|j  che|z  ^ca|r  ddai|
bung|f  chua|f  ruc|wj  ^cuc|j  ^so|zs  tap|j  ghe|zs  ddai|f  phuong|wf  hu|w
^trieu|zj  thieu|zr  ^ca|s  duoc|wj  ^cup|s  trai|j  chay|r  tam|zs  khoang|r  ^san|r
^bo|zf  duyen|z  linh|s  ddoan|s  ^chong|zf  nat|s  ^nhat|zs  bung|wf  dde|r  ddo|wx
^mat|zs  tha|r  lut|j  thuan|zx  ddoi|wj  tiem|zj  can|zj  ac|s  yen|z  ^quyet|zs
lot|j  ^buoc|ws  xam|z  ^giap|s  ^cong|zj  ^cau|z  lau|z  sam|ws  xua|w  dda|f
du|f  hom|z  ^chon|j  phau|zx  ^sap|ws  con|z  troi|z  lung|w  trung|ws  ^hay|x
thai|s  ^song|z  duyet|zj  hiep|zj  lam|zf  giac|zs  ^quy|x  com|w  ket|j  ^bau|zf
nghien|z  huyen|zf  ^truyen|zf  truc|s  ^khach|s  ong|zs  ben|zs  vuong|w  ^ung|ws  an|z
^xac|s  ^cat|s  ^vung|x  dang|j  ^tiet|zs  truc|j  phu|f  ^yen|zs  ^the|zr  ban|zr
mu|f  khoi|z  ^bac|j  thoi|z  ^nhom|s  ddang|r  ^uc|s  mai|s  khuyet|zs  thu|wj
^toa|f  ^ben|zs  trich|s  hoanh|f  ^mat|wj  ho|zr  vay|z  ^ban|f  suot|zs  ^tai|j
^bang|wf  ^ty|r  viem|z  ^ky|s  cot|zj  xuong|w  mach|j  hoan|x  ^ton|z  khat|s
^bui|f  ^huynh|f  chua|s  xom|s  kenh|z  mong|zj  ^con|f  ^tang|wj  suyt|s  ^lat|j
^cap|wj  lo|f  ^huu|wx  ^chuyen|z  bo|zf  ^ddoi|zr  ngao|f  long|z  mu|x  ^dan|f
khang|s  lan|f  ran|ws  no|zx  vang|ws  ho|j  ^toan|f  ^hoi|zf  cuong|w  trat|zj
^cho|wj  ^lan|zf  trung|f  tao|s  ^nhu|w  bach|j  lo|z  trung|wf  ^lang|f  tram|zf
phai|s  ^lai|x  vo|x  mui|x  oc|zs  ^than|zf  ^dau|zs  ddich|s  gon|j  lang|wj
^truc|wj  tho|wf  khich|s  ^tren|z  rang|w  ddung|wf  ^nen|z  ^ddan|  nhan|ws  anh|s
phan|zs  ^phat|zj  ^tai|s  ^cuong|wf  ^ao|s  kin|s  guc|j  ^neu|zs  man|j  nghi|x
tro|j  sat|j  dday|z  ^truong|wr  ^tieu|zr  thuong|wj  mo|zr  ^song|zs  ^cap|zs  mua|s
vot|wj  ^pho|zs  ^bo|r  can|r  ^thap|s  ^thay|zf  pho|zr  ^he|s  ^bieu|zr  menh|zj
rong|f  ^hieu|zj  loai|f  ddoi|s  boi|w  ^xet|s  ^triet|zj  ^diem|zx  tru|wf  hong|r
cau|zj  khanh|s  ngua|wf  ^manh|j  quet|s  ^cay|z  ke|z  du|w  ho|f  vien|zx
ddung|j  giau|zs  triet|zj  ^cung|f  chan|w  mao|j  thung|f  cung|ws  ^nhin|f  ^qua|r
dduc|ws  nhac|ws  ^chang|f  tiem|zf  tuyet|zs  bay|zx  ^thiet|zs  ddo|j  ^lap|j  ^mon|s
ba|s  ^ddao|j  chuot|zj  vet|zs  cup|s  buoi|zr  ^phat|j  tran|zs  co|r  ^tieng|zs
un|f  cot|zs  mat|s  lien|zf  ^ddinh|  lang|ws  chuyen|zf  ^hoai|f  dang|f  doi|zj
chac|ws  ^van|zj  nhau|zj  ^dau|zf  lot|zj  ^anh|s  ddau|zj  lan|zs  lao|x  ^tu|s
ngu|x  ^tieu|z  ^phien|z  ^ddau|zs  ngua|wj  doi|wf  ^muon|zs  on|w  ve|x  ^ap|s
cuoc|ws  ^hien|zs  hua|ws  bon|zs  ngam|ws  ddo|zx  ^cho|wf  doc|zs  ^vien|zj  ri|r
^chuan|zr  dan|zf  ^ve|r  lo|wx  ^goc|s  ^san|z  ^quyen|z  mong|r  tong|zs  ai|s
ngon|z  tay|zr  ^quan|s  ^chiec|zs  ^nha|x  nao|s  goc|s  net|s  ^khac|ws  tiec|zs
kip|j  bay|f  dde|f  rui|j  ^ddang|w  ^dda|  lung|f  thuyet|zs  truot|wj  uc|ws
huu|w  ^nhac|j  ^ddan|f  boi|zs  ^tho|j  nhan|x  re|zr  ^hom|z  ^soc|s  ^vuot|wj
^tung|f  ^giet|zs  ^lay|zs  ^can|s  me|x  ddut|ws  giuong|wf  sot|s  ^trang|w  ^thong|zs
^giu|wx  ddam|zf  ^ddot|zj  dap|zj  ^trinh|j  khoanh|r  ^cham|zs  bac|zj  ^tuong|wf  ^bien|zs
bep|zs  ^cam|zs  ^bo|zs  ^chu|s  khoa|r  suu|w  gian|zj  ^cu|j  am|zr  ^tra|r
lui|f  ^vua|wf  kho|z  trau|z  hut|j  vuong|ws  ^meo|j  ^tuoi|zr  ^moi|zx  rao|f
^chiem|z  ^bai|s  via|r  giap|s  ^loc|zj  ^ddac|wj  huoc|ws  loi|zs  ^noi|w  bu|f
tuong|wf  ^thuoc|zs  soi|z  to|wf  xach|s  ^nghia|x  ^ddo|zf  hau|zf  ngat|zs  ta|s
man|ws  ^phan|z  voi|wf  lua|wj  lan|zj  xa|j  ^ddang|  ^vinh|j  ^he|zj  ddang|ws
trai|r  may|z  xuong|wr  chan|ws  trang|w  ddua|ws  xo|z  ^ke|zs  vo|r  lam|ws
lang|w  nam|ws  no|wr  ^lieu|z  khap|ws  ^buc|ws  loc|j  trang|s  ^trom|zj  ^giup|s
lap|ws  hoi|z  ^luc|wj  xung|ws  ^thu|wr  ^trang|ws  mo|zf  ^hanh|j  ^sap|zj  lieu|zf
^vien|z  nhan|zx  ho|wr  nhip|j  trua|w  ^uu|w  tho|wj  tra|f  ^ddang|wj  ^cam|r
^ddo|z  ^gia|r  mang|w  sanh|f  gay|x  khuan|zr  ^chong|zs  ^cham|w  te|z  that|ws
da|j  giong|j  ^bach|j  ^tin|s  ^ten|z  oi|w  ^an|s  ^cuop|ws  ^huan|z  ^dduoc|wj
^cau|zj  ^su|wr  ^ddia|j  ^cuoi|zs  to|r  ^choang|s  chung|r  khong|zs  long|zj  cong|zr
vi|x  tru|s  dday|s  rui|r  bua|wx  ^thuong|wf  chang|wr  truyen|zj  tho|z  dieu|zj
^^tiep|zs  ^man|f  ^chung|s  thap|zj  ^^truc|wj  rau|z  ^le|zj  lanh|f  tom|s  ^si|x
^hang|x  ^cai|r  trong|z  ^du|w  ^chat|zs  nhieu|z  ham|z  min|f  ^banh|s  bong|zx
e|zs  dam|s  ga|x  ^che|zs  rong|zf  mau|z  bot|zj  nu|j  ^soc|zs  sut|j
tung|w  rua|wr  ^ddo|zx  ^khung|r  ^tinh|r  bot|ws  boi|wr  ngoan|j  tho|zr  ^hien|zf
dao|j  ^xa|x  ^cang|r  muon|zj  ^lac|j  rang|f  diu|j  ^phuong|wj  khieu|zs  ru|r
dat|ws  ^khuyen|zs  do|wr  van|j  ^qua|s  khieu|z  ^bo|zr  hay|x  ^me|z  ^lat|zj
^lu|x  lan|zx  chon|z  ho|zs  muoi|zs  ^quan|zj  mo|wx  ^con|w  han|zj  ^niem|zf
tron|j  ^that|zs  nau|zs  ham|j  ddon|f  ^con|z  ^het|zs  phe|zs  son|w  ^cua|wr
khoc|zs  ^sac|ws  ^cu|s  ddia|x  ddam|ws  lech|zj  xi|f  thiep|zj  xoay|s  ^gio|wf
^chet|zs  meo|f  mi|s  mui|f  lit|s  lap|zs  tien|zx  ^mau|zx  ki|f  ddac|ws
kep|s  ^thuong|wr  dde|z  xe|r  rot|ws  hoac|wj  cap|s  ghep|s  day|f  bon|s
^ky|x  bo|s  ^khan|zr  ^ddao|r  vot|j  tay|z  ^sat|s  bui|j  ^chan|zs  de|zs
^no|zx  can|ws  chung|wf  phuc|ws  nhan|zs  ^soi|z  ^ddau|  mong|s  hon|zx  ^tac|s
thoi|s  ^bon|zs  nham|wf  ^ngu|w  ^uyen|z  khoi|s  khoang|s  ^thuc|s  ^duyen|z  ^huyen|zj
mi|f  tron|f  ^ngan|w  ddo|s  man|wj  ^tham|r  trong|zs  ^tung|w  boi|zj  khoi|w
^quyen|zf  ^ddoi|z  ^vao|f  ^be|zs  ^tuong|ws  ^ba|s  nuc|ws  sut|s  ^choi|w  tho|j
xam|w  ^tran|zj  nhai|s  tham|zf  ^tham|w  chong|s  lay|z  phien|zs  dduong|w  ^tri|s
sanh|s  ^am|z  ^ddam|z  ^hoa|r  ^tao|s  gian|s  hoan|j  be|zs  nhanh|s  ^ddep|j
^su|w  ^han|z  ta|r  ngoc|j  bam|s  suong|ws  doi|x  ^liem|z  nai|j  nhua|wj
^nan|j  ddua|f  can|j  ddeo|  kien|z  ^nhap|zj  ^cuu|wr  ^vuon|wf  ddem|  thoi|zr
nut|s  lon|zj  ^kong|z  ^cang|w  ^khoanh|r  thoi|zs  trung|w  ^chao|f  ddam|zx  them|zf
^ddam|r  moc|s  ^thue|zs  khuyen|z  mun|j  ^hoat|j  dung|w  ngoi|wj  bong|z  bom|w
khien|zr  at|j  dai|j  ro|zj  ganh|s  tham|z  ^phong|s  ^lua|wf  ^quy|r  tue|zj
khon|zs  tuc|s  ^lang|x  ^tuyet|zj  ^lang|j  ^xoa|s  rua|f  co|wx  long|r  dde|zs
nghich|j  sep|zs  ^mau|z  ngang|f  thap|s  ^sach|s  man|x  ddam|  ngach|j  ^hien|zj
loc|zs  ^khoi|zs  siet|zs  xa|s  ^phan|zs  ^cam|zr  kip|s  ^vo|z  ^tro|f  ^chay|j
mo|wf  ddoi|zf  dang|z  vieng|zs  lot|s  thanh|s  tat|ws  ^tu|ws  giay|z  ^lai|s
muc|wj  cong|zs  ^can|zr  nut|ws  nuot|zs  det|zj  ddon|zs  thung|r  vui|f  ^chanh|s
^sua|wr  ^ria|j  lac|ws  ^qua|f  ^tuyet|zs  vai|f  sau|s  lay|zx  ddup|s  gach|j
^nuoi|z  ^kiem|zs  ^bao|j  khiep|zs  ^canh|s  tham|s  ^nghe|zf  cung|w  le|z  mieng|zs
vuon|w  ^tran|zs  ^can|w  ^vat|zj  ^ddien|zr  do|wx  ^bang|r  ^phan|r  ^viec|zj  tung|s
^len|z  ^to|z  ^giong|j  ^bich|s  dduoi|z  vit|j  moi|r  ^moi|ws  nuong|ws  khuon|z
^gai|s  ruong|zj  coi|wr  ^no|wj  manh|r  ^vi|j  ddieu|z  he|s  sau|zs  ^giac|zs
loi|zj  tut|j  map|zj  doi|zs  ddo|  ^rong|zf  quy|r  voi|zj  thach|j  thom|w
loi|x  ^kich|j  ^thach|j  tu|r  nam|zs  ^cuoi|wf  ^vung|f  ^ddam|s  ^lieu|zj  ke|f
ki|r  trieu|zf  dung|x  gam|zf  ^gui|wr  ^nghien|z  ^dong|f  tang|j  ^muc|j  ^tram|j
^loat|j  ^phe|z  ^he|f  luot|ws  ^ga|x  ^phu|r  ^mo|z  muon|wj  cat|zs  nham|ws
ddan|s  hai|x  ^viet|zs  hoai|j  ^hieu|zs  ^mac|wj  ddoi|ws  cau|zr  ^cuong|w  phoi|zr
cam|ws  kiet|zj  ^buon|z  ^trong|zf  keo|j  ^ddong|s  ho|z  ^toi|zs  lo|w  bac|ws
^day|j  hep|j  ^tro|wr  ^cat|ws  ^ma|x  ^thien|zj  ^bi|r  xong|z  nguc|j  gau|zs
^chieu|zf  nong|zf  tro|zr  ^nhip|j  khu|ws  co|f  ^dden|zf  ngay|z  ^moi|zs  ngo|x
ton|zr  quay|zj  ngon|s  ^ddo|r  luoi|wx  ^phao|s  ddao|  be|zr  ^moi|z  ^luong|wj
^kiet|zj  no|z  khon|z  nhan|wf  ^toan|s  no|zj  ^trai|r  ^nghich|j  ^gop|s  ton|zs
phi|f  ^tuong|w  ro|f  bon|zf  ^tan|zj  ^chi|j  goi|zs  ^mach|j  ^trinh|f  met|s
ron|zj  nhuc|j  ^nang|f  ngot|zj  ^toi|zj  dda|r  sap|s  luong|wf  ^van|zs  bep|j
^quat|zs  ^thinh|j  ^^o|wr  ^net|s  ^nui|s  ^ddua|  ^ddon|w  ^nho|ws  ^sua|wx  chan|s
^noi|s  ^truc|s  ^cu|wr  tau|zs  ^hop|j  ^phau|zx  long|zf  khop|ws  moc|zj  khoac|s
^han|j  ^xuc|s  but|s  ^chau|s  ^tranh|s  don|zf  o|zf  set|s  ^uong|zs  moc|j
ngung|w  ddinh|s  ^que|zs  hong|zr  ^moi|wf  be|f  ^muong|wf  ^giay|zs  ^hieu|zr  ^ga|f
len|s  ^song|s  coi|f  ^co|zs  tang|r  tat|s  lan|w  suc|s  thau|zs  huc|s
^dien|zj  cu|r  ham|f  le|x  bun|f  ^phuc|j  chuoi|zx  ^vay|s  ^ro|f  ^xa|r
met|zj  ^ddang|wf  chuoi|zs  ngac|j  rap|j  vu|s  ^lam|j  ^dda|s  ngoi|wf  ^khoi|z
chin|s  ^thue|z  va|j  ^chieu|z  xich|s  ^cuc|wj  ta|j  ^mong|z  rap|zj  choi|j
mia|s  ^tat|zs  bay|r  ^roi|w  meo|j  ^mau|zj  ^nhon|w  coi|z  ^ddo|zr  vinh|j
^siet|zs  vot|ws  dieu|zx  ^thach|s  che|f  nhat|j  chui|wr  ^vo|wx  he|zf  ^so|w
^ngo|j  vang|w  bach|s  li|s  ^som|ws  ^guom|w  ^thiem|z  dua|w  bi|f  bat|s
^ben|z  xon|z  ^ddat|wj  rac|ws  ddua|x  ^huy|r  tim|s  ^tram|f  ^khoang|r  ^dde|zj
^truyen|zj  ao|f  mot|zs  nhay|j  gin|f  ^la|j  them|f  ddam|zs  sung|wf  ^nang|ws
dde|zj  ^thanh|s  ^chua|wx  ^bai|x  ^trung|w  ^toc|s  va|s  sup|j  au|zr  bang|f
^than|z  ddang|wf  kiem|zf  ^mien|zx  ^sot|zs  choang|s  ^ddien|zf  chang|wj  ^^sang|s  gio|f
^troi|wf  ^xuyen|z  uy|s  ^von|zs  ^bay|r  ddam|j  ^sy|x  nguyen|zf  ^xo|z  nhe|s
vac|ws  quat|zj  bap|ws  thau|z  ghet|s  ham|x  ^biet|zj  luong|zf  ^so|wj  dua|wf
mang|f  troi|s  tang|s  ^bung|f  ra|f  chon|zs  xi|s  chot|s  ha|f  tuu|wj
ruoc|ws  ^tham|z  ^vien|zx  ^xang|w  can|zr  ^muoi|wf  ron|wj  ddo|f  vat|wj  ngo|z
^thao|s  ^san|wx  hieu|zs  ^phu|f  cum|j  boc|j  vut|ws  ^uoc|ws  ^sau|s  thieng|z
buong|z  dai|r  sua|w  loi|z  phong|r  man|zr  lo|wf  ^thu|s  vai|r  ^nguon|zf
ngon|j  ^rung|wf  kha|s  ^ve|zj  khoan|w  ne|s  le|zf  nhoc|j  ddeo|f  ^hoa|j
bay|z  moi|zf  gieng|zs  ^cham|zj  bup|s  ^lo|f  don|j  may|f  ^tam|zs  dep|j
che|x  ^nien|z  gian|x  nhat|wj  xe|s  ddong|j  ^bua|wx  got|s  ^tinh|s  bau|s
cua|w  do|f  ^mon|z  ^mang|j  nhi|j  chat|zj  ^bat|zj  ^chuyen|zs  tach|s  ^dung|wf
ti|j  ^quyen|zs  so|wf  ddien|zf  tron|zj  cai|f  nuong|w  noi|ws  nghieng|z  ddon|ws
^linh|s  ^ddau|z  o|w  khuat|zs  ^kho|zr  chuong|zj  chich|s  ro|zr  lun|s  nhat|s
luy|j  gian|f  huong|zs  ^a|r  ^^u|w  ^dieu|zj  ddap|ws  nghet|j  nghinh|x  xi|r
kieu|z  kiem|z  song|f  dat|j  ^tri|f  xit|s  ^dday|z  ket|s  ^ddiep|zj  ^tich|s
^phoi|zs  ^nu|j  ^gay|z  hot|zs  ^nang|w  ^muon|z  kheo|s  ^khat|s  ^buu|w  vi|s
phim|s  on|zf  ^quan|zf  ^chua|f  ^bach|s  vac|s  ven|j  suoi|zs  ^hue|zj  buu|w
but|ws  troi|zj  ke|zj  tu|s  ^rut|s  tat|j  choc|j  phoi|w  gay|s  ^de|zs
^sat|j  quy|j  ^thit|j  ^hoan|x  ^xon|z  ^go|wx  dan|s  ^giat|zj  ngo|w  ^ta|j
^ngo|zj  nep|zs  ^gan|ws  dua|wj  lau|zf  ^goi|wj  ton|wj  lop|zs  nhi|f  ^bong|z
gac|s  kem|f  ^trach|s  ki|s  khiem|zs  xin|j  ^ddap|zj  ^ddoi|wf  ^tuong|wr  ^duoc|wj
xai|f  xam|s  ^tong|z  ^be|z  quay|zs  tuoc|ws  ^lang|w  ^^toi|zs  ^hiem|zr  ^thoat|s
^xot|s  ^san|w  vinh|x  ^luan|z  noc|s  ^mung|wf  ^nga|x  sac|j  ^tham|zr  ^cu|w
va|r  xiec|zs  ^ddoi|f  bop|s  ^nhiet|zj  benh|z  pho|z  trac|ws  na|j  chu|ws
^^chieu|zf  ho|wf  tung|f  ngo|r  ^quai|s  ^luyen|zj  ^ban|ws  rach|j  mam|ws  ^ngo|wx
^muc|ws  huc|ws  ^triet|zs  cung|s  nhao|f  ^hat|s  dom|r  nhon|zj  ^bat|s  mom|zf
ngo|wx  ^ddat|j  mon|f  ^phia|s  suong|w  ua|w  rung|j  han|f  ^am|zs  mien|zj
^nhuong|wx  ^loai|j  ^loi|zx  gom|zs  ddinh|  ^thuc|j  loc|zj  khi|r  tran|w  ^mo|w
xa|f  tua|wj  lua|j  so|j  tre|zx  ^luc|j  ^lan|f  vanh|f  nhiep|zs  ^chim|f
^kan|j  ^tam|s  ^phung|f  lan|wj  ^boi|zf  nham|zj  ^guong|w  ^trum|f  ^ddoc|j  ^ddon|zf
the|zf  ^hap|zs  du|j  rom|wr  tuy|f  vo|wr  ^thay|zs  ma|j  ^mo|zr  ^thiet|zj
meo|s  ^it|s  nghen|x  cham|z  may|zs  ^nua|wr  bit|j  ^cu|ws  ma|s  ech|zs
chenh|z  ^hao|f  chuoc|zj  ^lua|wr  nhen|zj  hai|s  giang|s  so|wx  ^lua|wj  ram|zf
doc|j  ^loan|j  ^toa|j  nap|j  cung|r  vach|j  ^kha|r  pha|f  ^hai|f  tinh|x
^ddac|ws  ^khan|s  khau|z  hoai|f  ^ron|zj  cay|zj  ^ro|zj  nghiet|zj  ^thich|s  ^bang|f
boc|s  ne|zf  nan|f  toi|zf  ^khue|z  ^can|z  tam|s  nhang|f  ^loc|zs  phan|zx
^sec|s  thap|ws  me|r  ^bo|f  van|s  ^ho|zr  ^mat|ws  ^tom|s  ^tac|ws  om|zs
^thoa|r  hao|s  de|z  ^cam|zf  chi|f  ^van|j  ^moc|zj  ^chap|zs  ^chua|s  ddui|f
^la|s  ap|zs  xiu|r  luan|z  xao|f  chep|s  nghenh|z  va|x  dieu|zf  lach|s
ot|ws  ^hon|f  mac|s  voc|s  sau|zf  vay|zj  ngan|s  ^quach|s  ^co|wf  ^cho|s
tau|zj  ^cang|f  ^go|f  ^lo|zx  ^giua|wx  bun|s  tau|zr  ^bo|wf  khuay|zs  ^san|f
^tuong|wj  ^ra|f  giot|j  ti|s  ^nho|wf  noi|zf  neu|z  ^khuc|s  ^ddot|zs  ^than|zj
^ve|s  ^noi|zs  ngua|wr  cheo|f  ^chan|wj  ^hon|zx  nay|r  seo|j  tuong|z  ^hat|j
^khang|wr  ^trai|j  ^vuon|w  rinh|f  ^lao|x  top|zs  cuoc|wj  ^de|zx  rach|s  nam|s
mong|z  dduc|j  hat|zs  ^ti|r  gay|zf  ung|s  ^rung|f  ban|zj  chuong|z  ^diep|zj
vang|s  ^ddoan|  khoai|s  nuoi|zs  kieng|z  khet|s  dim|f  mang|ws  ^biet|zs  tung|j
^chot|zs  beo|f  ^tam|ws  rung|s  thinh|s  ^luot|wj  thoang|s  ^lop|ws  tuot|zj  chuong|zf
^nhay|r  ^lay|zj  nhanh|r  ^suyt|s  ^meo|f  con|zf  cut|j  ^lon|ws  ^ty|j  re|x
^chem|s  ^am|s  mien|z  ^phut|s  phieu|z  ^khoa|s  pho|wr  xum|f  nhuom|zj  cay|f
^xe|zs  ^keu|z  bu|s  au|z  nhot|zs  gia|x  nga|r  dong|z  voi|f  gay|zj
^mach|s  ^nen|zf  ^kinh|s  ^khe|z  dep|s  tam|zr  ^lac|ws  nga|f  ^phi|s  ke|zf
vat|zs  ^hon|z  ^ruc|wj  ddeu|zr  ^tha|r  chut|s  quang|wj  ^trang|f  ^khai|r  ^an|zr
co|ws  ^noi|zr  xit|j  co|zx  gat|ws  gio|wr  hong|j  quac|wj  lun|f  ^ddam|zf
phang|wr  quyen|z  xe|z  ^mieu|zs  ^boc|zs  to|w  ^hien|zr  phien|zf  ^ru|r  ngat|j
ngan|zr  ^goi|j  muoi|zx  treu|z  xo|w  xan|ws  nghen|j  do|zx  ^ve|x  ^kich|s
be|r  tram|r  ^tho|wj  dday|zs  ^thin|f  uop|ws  bua|s  ^dden|  ^tiem|zf  ^chu|wx
^^nong|s  ho|ws  ^lap|ws  ba|j  thac|j  ^du|f  ^rap|zj  ^voi|ws  nhom|z  mang|r
^tram|z  nhuong|wf  ngoi|f  ^tro|wj  ^khuong|w  cay|zs  thuan|zf  nhoi|zf  ^mau|f  chao|s
^kien|zj  at|s  ^ngu|r  cuoi|wx  ^ddac|s  thuoc|ws  bon|j  ach|s  ddu|  ddong|zs
am|r  gan|z  ga|j  han|wr  ^gio|s  quy|f  ^man|x  soan|j  chop|ws  vet|s
^boc|s  ^linh|x  ^mui|x  tru|f  ddem|zj  xat|s  buong|zf  ^ruou|wj  hon|f  nhao|s
lay|zf  ^nghiem|z  ^dan|zf  van|z  ^tap|j  chan|zr  bam|zr  ^nghi|r  ^ddon|z  xu|f
soi|wj  ddai|s  ^keo|s  ^tram|zf  ^goi|s  cha|r  rich|j  chien|z  nhan|w  ^lua|s
coc|zs  ^cum|s  my|f  ^rat|zs  tham|ws  ^^o|zr  ngam|zj  soan|s  ^thap|ws  ^viem|z
trut|s  be|zf  mo|f  chia|f  ren|f  ^to|zs  ^mai|s  ^sep|zs  ^khao|r  ^cong|zs
^suoi|zs  cam|zr  ^roi|zs  nhoi|zs  viet|zj  than|r  so|z  lanh|s  ai|r  ^hua|ws
^thep|s  buoi|wr  de|f  ddung|wj  bo|w  xot|s  ^tiem|z  deo|r  hien|zf  ha|r
hach|j  ^danh|f  bo|j  ^tuyen|zs  tac|j  ngam|z  ^nham|z  ^tran|f  mit|s  nap|ws
^xep|zs  ^ddang|wr  ^thuc|ws  giat|wj  ^ddap|s  ^lau|zf  gat|zj  ra|x  ^cuong|wx  lep|s
sam|f  ^biem|zs  luoi|wf  ^cu|f  lung|x  boi|s  ^hut|s  dan|wf  ^nhon|zj  xo|zr
rap|s  muon|z  bay|zj  thuo|wr  toi|w  ron|zs  nho|wr  lot|zs  ^phien|zs  ^buon|zf
^ham|f  boi|z  rang|wf  ^ngoi|zf  ^vang|ws  ut|s  be|zj  soi|r  ro|z  het|s
^tam|zf  non|s  tran|s  soi|s  ^bup|s  ^rua|f  ^trach|j  vo|wf  te|s  on|z
ngao|s  ^kenh|z  chanh|r  bia|f  thinh|j  ^ddung|j  ^pho|zr  ^tom|z  ^hoang|r  hau|zs
lung|wf  ^giay|z  soi|wr  ^hoi|r  lia|f  ^det|zj  ^may|z  ^trao|f  ro|zf  ^dung|wj
^cu|r  ^long|f  ^buoc|zj  quan|zs  miet|zj  phot|ws  vach|s  via|s  ^nhuc|ws  xoi|z
^tui|s  ^hai|x  ruot|wj  cao|f  coi|x  ban|w  sam|z  tot|s  ^chiem|zs  cu|wj
yen|zs  ^an|z  rung|f  chung|w  a|j  cong|x  bon|zj  ^cung|r  gat|wj  ^chup|j
nau|z  tap|zs  coc|j  tra|s  lung|wr  vuong|z  trang|f  ^dden|f  ^su|ws  nguoi|zj
mai|f  quat|zs  ^liet|zj  ngu|wj  rai|r  ^lo|z  ^^tu|w  muoi|wf  ray|zx  hu|r
na|f  nen|zs  ^ddu|r  ruoi|zf  ngop|wj  ^ddam|  gang|ws  ^ho|j  ^tuat|zs  luu|wj
chom|z  ^tru|j  au|zs  giuc|j  ui|r  khep|s  ^ho|zs  ^nhiem|zj  min|j  bu|wj
^nguoc|wj  ^chuc|s  ^that|zj  ran|j  rong|z  ghe|s  nhon|j  cuom|zx  not|zs  ^moi|j
niu|s  ddan|r  gio|zx  ^mac|j  nan|zf  gion|f  cheo|s  ^mat|zj  ^khoi|w  ^giay|f
up|s  ^beo|s  ^loi|zs  huyet|zj  cuon|zj  nhin|j  nuot|zj  luong|wx  dduc|s  soi|ws
^cot|zj  ^mich|j  san|ws  rot|s  ^tron|zs  ^truc|j  ^gao|j  e|z  tham|zs  ^phai|s
^cuon|zs  nup|s  muong|w  ^rac|s  chanh|s  ^tram|w  ta|f  ^ban|w  ^vuong|wj  ngoat|wj
^cong|zr  ^oc|zs  ^canh|j  rao|s  ^ngat|zs  ^gianh|f  ^ai|s  ^kieu|zr  lum|f  neo|r
^ddot|wj  ^muu|w  ^chang|wr  ^ddung|ws  ngo|ws  am|wx  ^nhoc|j  ^giang|r  ruc|j  ^diec|zj
^ddau|zj  lan|zr  ^ddinh|r  suon|wf  ^tung|wf  the|z  ^mao|j  lang|s  ^trung|s  ^the|r
^huong|wr  ngong|s  bong|zf  uon|zs  giay|zf  ddoan|  yem|zs  ^no|wr  ^ddon|f  ^chan|s
^ngua|wj  ^quen|z  tan|zf  ddem|zs  ^suong|w  chiet|zs  ^mu|f  ^ngung|wf  riet|zs  ^xung|ws
^ddong|zs  tam|w  dam|zf  ^xu|ws  ^ac|s  ^rach|j  vo|s  lung|s  ^thanh|j  ^khon|zs
^tran|z  henh|z  ^phung|j  ^giau|zs  ^that|ws  chum|f  ^co|r  ^thuyen|zf  ^hau|zf  ^lang|s
ky|j  ^gau|zs  ghe|z  suc|j  ngut|j  chieng|z  ^hon|zf  ^lanh|j  nay|zs  ^com|w
nao|j  tuon|zf  tuoc|zj  ^vuong|ws  ^co|f  ngun|f  nhuc|ws  thom|r  trac|wj  xuoi|z
^mac|ws  ^bong|zx  ^buoi|zr  ^dai|r  can|zs  phuot|wj  li|f  can|f  ^nguyet|zj  ^hum|f
^chuot|zj  xin|r  vung|j  chen|f  chuoc|ws  xung|w  ^tiep|zj  han|s  chao|r  ^gian|zj
buom|ws  ^ngan|f  ^bong|r  ^la|f  ^tiec|zj  bua|r  hang|wf  ^khoc|s  tuoi|ws  go|x
phong|zf  cam|z  que|r  ^mam|zf  ^minh|f  nhet|s  nhieu|zx  ^sam|z  khiet|zs  hui|j
hum|f  ddoa|s  ddo|zs  dam|wj  ^hop|zj  ngo|s  ngui|f  ken|zf  bam|zs  nhac|s
oa|f  kep|j  muoi|w  ^cum|j  ^di|j  nhuoc|wj  ^mit|s  nong|f  mam|z  suoi|wr
^vet|zs  ran|w  ^rac|ws  ^coc|zs  luy|x  ^lieu|zf  ^ngu|wx  ^loai|f  lo|zs  ^lang|ws
ne|zr  ^ham|j  ^lo|wr  cun|s  tuy|j  thoi|f  ^ngot|j  hat|ws  nhoc|s  coi|zj
^tan|r  ^nghiep|zj  nguyet|zj  ^can|j  ^ty|s  ^mot|zs  ngu|wf  mung|f  ddan|  dat|s
a|s  lau|zr  ^hao|r  cam|s  no|s  bua|f  quyt|s  ^ham|zf  duong|wj  ti|f
quyt|j  ^tich|j  ^ep|s  giang|wf  chang|w  hem|r  ^xe|z  ^ton|zf  van|x  kiep|zs
^khi|s  vong|zf  ^tiec|zs  gam|w  ^mua|s  nghien|zf  ^vy|x  ^giau|f  ^cuoi|ws  gieng|zf
manh|x  vun|j  thoai|r  ^ganh|s  ^que|z  ^boi|zj  chai|f  ^thuot|zj  ^^chinh|s  ^ki|f
^nhuan|zj  chung|wx  ^nghi|x  tuan|z  ^tham|ws  uot|ws  lua|ws  cuu|wf  giong|z  ^lu|wx
^te|zs  ^vung|wx  vo|w  ^cho|wr  ^chia|f  ^dinh|s  ^chan|w  co|j  ^tot|zs  ^ddieu|zs
am|zf  xon|zj  ^bay|zx  ^xom|s  ^ngu|x  vo|zf  khu|wr  nat|j  mai|r  lieu|zx
^ddoan|j  ^on|z  hung|w  ^nga|f  ^chang|wj  ^^thuc|ws  cong|zf  soai|s  ^lieu|zx  ^rang|j
bam|zf  toi|r  thac|ws  ^ung|r  sao|f  tro|w  xuong|zf  khung|f  ^phan|zx  ne|z
^yeu|zs  ^nem|s  ^suu|wr  ^sam|zf  hang|w  mao|f  ^thoi|s  vat|ws  ^mong|s  ngau|zf
^ngap|zj  ^thot|s  chat|s  ^loc|j  dduoc|zs  ^duyet|zj  ^ke|z  ^trau|z  thet|s  ^phep|s
^ddo|  ^ket|j  ^lan|z  mut|ws  ngua|ws  ^vi|x  ^vai|f  bua|wf  nha|x  ^chai|r
lap|wj  ^dang|z  ^ghe|zs  di|x  lu|wx  vong|x  ^chat|wj  luon|wj  ^vai|r  biem|zs
hich|s  nem|zs  ^hoanh|f  ^vap|zs  ^chieu|zs  ^mai|x  ^ddang|s  ram|wf  ^no|z  tac|zs
^sung|s  ^vanh|f  ^phong|r  ^tran|w  ^thac|s  ^rui|r  bip|j  hung|wx  ^gio|zx  ^luon|z
tit|s  ^un|f  say|r  ^nhiep|zs  thuc|j  nanh|f  ^tong|zs  giang|w  bieu|zs  ^muon|wj
doi|w  sa|f  ^trung|f  ^om|z  ^vo|wf  ddieu|zs  ^toc|zs  ddiec|zs  ^lui|f  ^dduong|zs
^am|zr  giac|wj  xao|r  nin|s  ^nhi|f  nap|zj  ^giong|zs  bay|zf  ngam|zx  ^don|zf
gat|j  ^sam|ws  ^hiep|zs  ^da|j  ^huan|zs  la|r  ^so|zr  coi|zs  ^ddam|j  ddat|s
loa|x  nach|s  ^chenh|z  sac|wj  thua|wr  rom|w  ^va|f  ^be|zr  ^ret|s  goi|zj
nguy|j  ^kip|j  gung|wf  trao|s  gang|w  ^tu|f  ^gie|x  hien|zr  ^vach|j  ^mu|x
ran|s  ^ddong|zr  vay|zx  ^lach|j  troc|j  mu|r  ^nghet|j  keo|f  ^hen|j  ^ao|r
^chin|s  ^ung|w  ^mat|s  het|zj  i|f  ^toi|ws  ^duoi|ws  ^thom|w  ^ngon|j  ^phan|zj
^nhau|zj  tho|r  buou|ws  ^ddam|ws  ddon|zj  ^dao|j  ^sau|z  cao|j  bich|s  bieng|zs
ngau|zx  ^phuong|wf  khiem|z  kim|f  ^ho|zj  hi|s  ^ven|s  ^mi|s  ^trung|ws  bam|w
^re|z  ^cuong|zf  bay|zr  phien|zj  tia|r  ki|x  ^cam|s  treo|f  ^ne|s  cong|f
^trong|z  toa|j  ^ddang|ws  chung|wr  ^mo|r  quat|j  xuong|ws  ngong|z  ^ddung|s  ro|wj
lo|j  hoi|zr  ^ddo|j  ^bon|zf  bat|j  lan|z  ^go|zx  loi|w  ^khau|zr  bia|j
^tu|r  ^khang|s  ^chang|j  tan|ws  ^du|j  tre|zj  ^hang|j  ^cua|r  ^buoi|wr  ^ddieu|zj
^don|j  ^ddua|ws  ^cai|x  uom|w  ^trac|ws  to|f  gap|zj  lat|s  ^giot|j  nhep|s
chap|zj  lam|zx  luoc|zj  ^ran|ws  ^ddem|  ^ro|z  nen|s  ^chinh|r  xo|r  ken|f
^dde|zs  ^lenh|zj  xoai|f  tit|j  ^tinh|j  dua|ws  nham|r  huan|z  nha|r  vien|zf
^ngon|z  ve|zs  vom|f  bot|j  cam|wf  hit|s  troi|zx  hop|ws  ^lung|s  xiet|zs
cho|ws  ^nghien|zj  cua|ws  ddong|  ^nhieu|z  mut|s  cui|s  vo|zx  cuc|s  ^dde|z
yeu|zr  ^bo|s  sung|w  ^khong|zr  ^xi|f  loc|s  non|z  oan|s  ^nao|s  ^tang|j
mui|s  cui|r  u|ws  xinh|f  sui|f  xop|zs  ^che|f  thang|wf  ^dua|w  u|r
^mau|s  truat|zs  ^xuong|zs  chen|s  be|x  hanh|x  tron|w  ^mui|f  quan|zr  men|zs
quay|z  due|zj  trot|s  go|f  ^nam|zj  boi|wf  gong|zf  say|zs  nhich|s  phao|f
^cham|j  thien|zf  tan|r  tron|wj  thoc|s  gioi|wf  ^khoa|r  banh|r  giam|zx  xoi|w
tang|z  trui|j  ^dduoi|zr  ^xong|z  ngoc|zs  ^uan|zr  ^tuyen|zf  vang|j  ^ron|wj  tran|z
mach|s  qui|s  venh|z  ^bun|s  ^ngoai|f  ^duong|wx  nhoa|f  vooc|j  xeo|r  ^but|s
nan|ws  ^xa|s  vap|zs  ^hoi|zs  ^bui|j  ^nam|zs  ^vong|j  ^niem|z  ^hoc|s  vuong|wj
tham|wr  ^lau|z  tram|f  tuyt|s  ^trac|s  thot|s  em|z  phat|zj  quyen|zr  the|zj
^tit|s  rung|w  tot|zj  ^nhan|f  ^nop|zj  gui|x  loang|x  ^on|zr  ^ho|z  nhoang|s
^nghiem|zj  cuu|wr  ^tiem|zj  phoi|z  ^gap|zs  khoet|s  rot|zs  thut|j  ^ken|zf  ngoai|s
^cho|ws  ^day|z  tuoi|wr  ^nhiem|zx  buc|wj  ke|x  ach|j  ^gieng|z  ^ghep|s  mi|j
^nhua|wj  ^mao|x  ^xuong|w  theu|z  lo|s  triet|zs  day|x  ^nam|ws  ^noi|ws  ^dduong|w
chiem|z  chau|zj  ^ke|zr  ^map|zj  voi|w  ^be|f  ^muc|wj  ^cap|s  ^khong|zs  nho|zr
^ray|zx  loet|s  ^cham|f  canh|f  ^truot|wj  ^bien|zj  nhon|wf  ^ut|s  ^lang|wj  boi|ws
^dday|zx  ^mieng|zs  no|w  nhay|s  ^con|zf  ^set|s  ^nhat|wj  kinh|f  ben|s  si|r
^tham|s  ^toa|r  ^ta|f  ngay|s  ^doa|j  luon|w  ^ddoi|wj  ^tay|zr  he|z  ^thieu|zf
^ddeo|f  hu|s  ^kinh|f  ^nhue|zj  leu|zf  muot|ws  nhan|f  tao|r  ^khoi|s  xen|s
dui|f  ^ang|s  ot|zs  hoan|s  ^mai|j  ^lon|wj  choi|s  voi|z  ^dang|s  ^sip|s
noi|z  bet|s  ^loi|z  than|ws  ^man|zx  cap|j  lieng|z  ^sung|wr  ^bam|s  ^^soc|zs
^xich|s  ^boi|w  ^na|f  ^mong|zj  ngoi|w  keo|r  choi|zr  ^ddoan|s  ^tao|f  ^pho|wr
ruoi|wx  ddang|f  chong|z  mit|j  xao|s  bim|r  ^xay|r  ^^ddiem|zr  ^via|r  ^dep|j
^ruoc|ws  thua|w  ^lum|f  ^tuc|ws  ^cu|wj  que|zs  vuot|zs  ^^e|zs  roi|zx  tui|r
^dinh|x  ^bep|zs  nguong|wj  ^trang|j  ^tho|r  non|x  ^nhan|zx  tri|x  ^chuong|z  ^tron|j
choc|s  ^rao|f  ^lu|w  re|z  choang|r  ^vac|s  dot|zj  ^ddap|j  ^gia|f  re|zx
^tuoc|ws  gom|wf  ^thu|j  goa|s  ninh|j  ^manh|r  nho|j  ^phi|f  khai|s  to|ws
chap|ws  ^khac|s  bot|zs  ^dday|s  cha|f  ^chuoi|zx  nan|r  ^khieu|zs  ddia|r  di|s
^khoang|s  kieng|zr  ddung|f  nac|zs  a|r  ^sanh|f  ^khoe|r  ^luan|zj  ^^o|zf  phuong|wj
cop|j  phac|s  chau|zf  sen|zs  cau|s  dao|f  khoang|ws  ^xam|z  ^tien|zj  ^ddieu|z
muot|wj  chip|s  ngheu|z  ^co|zx  quang|s  ^ddut|ws  boc|zj  ^ddam|zj  phu|x  ^rot|ws
hen|f  ^tan|zf  lut|s  ^tien|zx  ^nghe|f  ^thac|j  ^ngan|zr  ngon|zs  nhot|ws  ghe|r
^giong|s  nhu|x  lim|j  thuot|ws  doi|zf  ^luot|ws  ^thuyet|zs  ^tach|s  chay|f  hon|wf
^nang|wj  quet|j  ^pheo|f  ^vo|r  ^tue|zj  ^rang|w  oan|wf  gio|w  dai|x  sut|ws
gion|wx  ^nong|zf  ^rua|wr  ^khon|z  ty|j  ^thoi|zr  sung|r  ^vam|f  ^coi|wr  cop|zs
ty|f  ^benh|z  nhang|wf  vut|j  ba|x  thung|wf  phi|r  ^lap|zs  phong|z  ^khep|s
nghen|s  sung|wr  cuong|zs  sao|s  ^mia|s  ^ddia|x  ban|zf  diem|z  ^ddoi|zf  se|z
^dua|wf  nhao|j  beu|z  ^thoai|s  chuon|zf  ro|w  liu|s  ^gach|j  ^dan|zx  hung|wr
^chuc|ws  toat|s  ^thoi|z  ^khuat|zs  ngon|zr  ^doan|x  ^vo|wr  xiem|z  huou|w  dat|wj
ddom|zs  vo|ws  dom|wr  ^ngung|w  ^ren|f  ^thap|zs  ^nho|r  goi|r  oc|s  gai|f
xoan|w  nai|r  ray|zf  choi|f  lang|j  ^vit|j  leo|r  ^nghen|j  ^luoi|ws  rai|x
ddan|zj  trong|f  ^^e|z  sam|zs  hoc|s  gao|f  ^quy|f  nguong|wr  dop|ws  ^khi|r
^man|j  phach|s  soc|j  ^roi|wf  suon|z  ^dde|f  ^phieu|z  ^chao|s  so|f  nhung|s
loa|f  han|x  bai|s  lieu|z  ^ong|zs  phang|w  phui|r  ^xuong|wr  ^thien|zf  nhom|f
^bong|zf  quang|w  ^ghe|s  bui|s  nop|ws  ap|zj  tham|zj  ^doi|w  ^ddoat|j  han|z
xoan|ws  hien|z  ^ddinh|s  ^ngua|wf  ngo|zs  ^sap|s  ^to|w  cham|f  te|r  u|w
^han|s  chuong|wr  ^met|zj  ddan|ws  ^ngac|j  ray|zr  ^au|zr  ^cuoc|ws  ^thap|zj  ^lon|zj
^cho|zx  lom|x  ^en|s  then|j  ^nut|s  nghien|zs  nghe|s  phan|f  manh|s  ^nin|s
^thon|z  a|f  ^tang|f  ^trat|zj  ^mam|z  ^lo|wx  bo|z  ^trong|zs  hong|z  ^kiem|zf
^gom|zs  ^huyet|zs  thot|ws  ^tan|f  ^pha|r  kheu|z  chay|z  say|zr  cuoc|zs  ngat|wj
^nhan|ws  tha|f  dan|j  gieu|zx  ^nhe|j  uat|zs  eo|s  ram|zj  ^hot|zs  ^mieu|z
^rung|s  ^tay|f  ^xiec|zs  buc|j  ^dip|j  xui|s  benh|zf  buom|zf  su|s  ^cau|zs
^nam|wf  bo|wr  dam|zx  ^cheo|f  ngao|j  ^chap|ws  ^dap|zj  lan|wf  ^dduc|s  ^khiet|zs
bang|s  ^nhan|x  gay|zx  hoi|s  ^uong|z  ^bom|w  ni|r  di|f  ^xa|f  ^on|w
cuu|wx  ngam|zr  ^cuc|s  ^thung|f  nac|j  xinh|s  lang|wr  got|j  tuong|zf  ddam|wf
^tron|f  ^ngon|zr  ken|s  tuy|r  ^phot|ws  dday|f  ^cao|s  truy|j  ^lo|j  gut|s
bit|s  lay|j  ^tai|r  gom|zf  ^tuy|f  vung|x  thieu|zf  gio|r  leo|s  po|z
roi|s  hon|ws  ^thuoc|ws  ^bay|z  vo|f  ^ta|s  ^long|zj  ^suong|ws  ^se|r  ^ngheo|f
^ddoc|zs  ^rap|j  quay|zr  ^vot|ws  ^cung|x  ^kiep|zs  uyen|z  ^^ngay|f  muong|zs  xieu|z
^bot|zj  ^lot|zj  ^buong|z  ^xi|s  cu|f  tep|s  cang|wr  ^che|z  te|zr  ^te|z
truong|ws  ddenh|z  ^chay|r  cut|s  ^nhoc|s  phot|zs  ddanh|f  ^vui|f  phang|f  nham|f
^dieu|zf  ^ta|r  ^sut|j  ^ddien|z  ^to|wf  gon|z  ^mang|w  ^lau|zr  ddang|x  ^khan|w
^ddo|s  me|f  suong|z  ^chuoi|zs  oi|zr  bung|w  ^mai|r  ^rong|zj  ^ki|r  ^soi|s
^trich|s  ^muoi|zs  ^bo|j  nhech|zs  banh|f  mieu|zs  loi|f  ^chiu|j  ^bot|ws  nho|w
xe|zj  suyen|zx  mim|r  ngo|zr  ^lan|zs  ^ddeo|  chuong|ws  phinh|f  ^tuc|j  ^xau|zs
^dda|r  ^trai|x  nhang|w  ^gay|x  ham|w  ddut|s  hui|r  ^ngay|z  khoe|s  nhang|ws
hot|ws  xung|s  ^cha|r  mo|s  ta|x  ^tach|j  xoe|f  ^nuot|zs  ung|w  meu|zs
^huc|s  ^do|wr  lui|j  ^la|x  chai|r  chuc|wj  ^cat|zs  ^khuon|z  ^dau|z  ^se|z
dan|zs  ^chac|ws  hac|j  ^nham|zf  tuyp|s  ^nghin|f  ddan|wj  ^bit|j  ^duan|zr  hoi|wf
^nao|f  ^cai|f  ^chat|zj  ^diu|j  ^chu|w  tam|wf  quay|zf  ^dung|j  ^diet|zj  song|zr
mi|x  com|zs  ghenh|zf  san|s  ^ngan|j  ^day|zj  ^oi|z  ^chan|zr  ^cam|j  ^loi|zj
^nhen|zj  ^canh|f  ngai|r  ^hoi|ws  trung|x  ^van|s  ^nhuoc|wj  op|zs  ven|s  ^cham|z
^hao|s  ^moi|r  i|x  man|zj  uan|zr  gheo|j  ^dien|z  ^ram|wf  mia|r  vang|x
muop|ws  ^tong|f  dang|wr  ^chop|zj  oi|zs  phat|zs  chong|zr  ^nguc|wj  ^ruot|wj  bich|j
^doc|zs  ^nhech|zs  oi|z  em|s  rong|zx  ^mi|f  ^cua|w  ^hoi|w  van|wf  linh|f
^chap|zj  ^khiem|z  ^tao|r  ^tha|f  sung|f  han|zs  ngui|wr  ^bau|s  luyen|zs  ^pha|f
^thieu|zj  com|zj  ^chieu|zr  ^mung|f  ^khieu|z  ^thuat|zj  trau|zf  tong|f  ngat|ws  nhem|f
thop|s  ^cha|f  nhi|r  ^bay|zf  hong|f  ddac|j  lenh|z  ^thac|ws  ^ve|z  xoc|s
^me|zx  nieu|zj  ^ddan|s  sinh|s  tau|zf  ^binh|s  diem|zx  ^kheo|s  ^ngam|zj  sap|zs
bi|r  ^xo|zr  ^long|zf  xot|zs  nho|zs  doi|zx  ^ddon|wf  tet|s  ^hut|j  y|f
nau|s  ^lung|x  vet|j  ron|z  khat|zs  nhap|zs  ^nhien|z  vung|wf  ^ddat|ws  ngam|zs
khoai|r  ^mo|zj  ddieu|zr  muoi|zj  o|s  ^tuan|z  ^din|f  mep|s  nac|wj  ret|zs
ngan|zf  tanh|f  ^chut|s  xet|j  buot|zs  u|s  yem|zr  xoi|ws  thoi|r  cu|wf
sung|wx  quang|f  ddiu|f  ^chong|s  de|r  ^han|x  dduc|wj  man|zx  nguoi|w  ^nguong|wx
^vi|s  chom|f  ^ddua|f  tap|s  quat|s  en|s  ^^chuyen|zr  ^nhat|j  sa|r  mat|j
^tat|ws  nhue|zj  chia|x  ^vieng|z  ^ruc|j  ^phoi|w  than|s  ra|j  ^luong|z  ^ngai|j
^vay|z  gi|r  ^nau|zs  ^mieu|zx  ^khiep|zs  ^cam|ws  xiu|s  mau|zj  ^sat|ws  mien|zs
nang|zx  huc|wj  quet|zj  dan|wj  khoan|ws  luan|zr  chu|wf  ngom|wj  ^dut|ws  ^coi|f
^sac|j  ddiem|zf  ^hoac|ws  ^noi|zf  vua|wj  quang|zf  kham|w  ^buu|wr  keng|r  sup|s
^sung|wx  ngai|f  ddiem|zs  sai|r  hot|zj  van|zf  ngung|f  xeo|s  ngac|s  huynh|f
^sach|j  troi|zf  ^gioi|r  ^sa|f  ^uom|w  tieu|zs  ngu|j  ki|j  ngut|s  ^ddoi|s
^^nhuong|wj  ^vuc|wj  ddo|w  ^gin|f  ^vat|zs  ^hy|r  sua|r  ^doi|wf  sen|z  ^nguu|w
gom|ws  ^nhi|s  ^boi|s  chan|zf  vay|zf  ^ddo|zs  ^giang|w  ^keo|j  ^thoai|j  nhan|r
hang|zx  gium|f  ^xe|r  ^hung|wf  ac|ws  kho|wf  ^mep|s  nem|zj  ^mi|x  sua|ws
thang|wj  van|f  ^dday|zf  bi|x  ^giang|wf  ^nhuong|wj  ^ddich|s  veo|j  te|f  guong|wj
chon|zf  ^luc|s  nho|wx  ^teo|f  ^rao|s  ^moc|s  thao|j  ngang|s  ^nhon|zr  ^ton|zs
^luu|wj  tray|zr  ddoa|j  liem|z  truong|zf  nen|zj  ^du|wx  trien|zf  ^lach|s  dot|zs
^gian|x  khuoc|ws  gam|wj  ^chich|s  ^thoi|ws  ^hien|z  ^nen|s  tiet|zj  ^dde|r  lu|wf
vay|r  ne|f  ^thang|wr  ^nup|s  sang|r  cui|x  nhu|r  nan|w  ^boi|zs  thoi|w
xoi|s  nhun|s  ^xe|s  triu|x  ^ngan|s  ^to|f  thiep|zs  hoc|zs  mau|zf  ^ddiem|zf
^bo|z  ^bu|f  ddanh|  ^chon|zs  ^meo|s  ^cay|zs  so|zj  vai|x  ^can|ws  oam|w
^manh|s  hom|f  nau|zj  cam|j  tan|zr  ^cu|wf  xap|zs  phung|j  kem|x  lao|s
phun|f  ran|zf  hoi|wr  noi|f  la|x  ^ma|s  ^phac|s  khoat|s  ^neu|z  ret|zj
gu|f  ^cau|zr  ^may|zs  ^sup|s  khe|zs  ^lo|w  ne|r  ^dde|  nguoi|z  ^xoi|z
^thiep|zj  nom|w  guoc|zs  ma|r  choang|f  xau|z  ^phuot|wj  vuot|zj  ^phan|s  lao|f
cay|j  tut|s  nhi|x  lom|r  xeo|f  bui|f  ^bap|ws  ^tan|s  ^suu|w  ria|f
tom|f  ^hu|r  ^giac|s  lat|ws  ^nguyen|zj  phap|zj  hu|f  hu|x  ^lat|s  ^nguy|j
mong|j  nha|s  chun|f  tro|ws  ^ngai|f  ^gia|x  ^chon|z  ^^bao|s  khat|ws  ^goi|r
^ham|z  xich|j  ^tho|wf  ^diem|z  ^di|x  ^mon|f  thay|f  ddon|wf  chang|wf  ^xoai|f
hot|s  ^moc|zs  bam|zx  ^ddoong|f  ngoi|s  ^dau|zj  thay|z  rat|s  ke|s  ^nhac|ws
^dam|s  ^them|f  ^thieu|z  lac|s  chuoc|zs  ^vom|f  riu|f  ^ngu|wj  nuop|wj  thiec|zs
mich|s  ^dan|s  ^not|zs  ham|s  cong|s  ruoc|zs  ^le|x  xuoc|ws  ^soi|wj  oai|r
pho|wf  cam|w  xoi|zs  cach|j  ^tut|j  ^vang|zf  ^ghet|s  phon|zf  vit|s  ^gian|r
^thi|f  ^cot|zs  thon|zr  truan|z  mong|zf  vay|zr  hau|f  ^ruong|zj  ^xam|w  gie|z
vu|f  xuyen|zs  ^nham|ws  ^duc|j  than|wf  ^vac|ws  ^hai|j  che|zf  ^nut|ws  ^thuan|zf
khe|x  ^ngoi|f  giam|zs  nhim|s  ^trua|w  bam|wj  go|wr  bet|zs  ^ddem|zs  giuong|w
^ngau|zx  ^xa|j  bap|zs  ^xai|f  quan|zx  tum|s  ban|zs  ddun|f  ^top|zs  vut|s
muon|ws  ^goa|s  chit|s  ^ddiu|f  ^pu|f  ^gung|wf  ^lam|ws  nhit|s  ^truong|z  ^giang|f
^khap|ws  ^to|ws  ^kham|z  ^trung|wf  ^ddoai|f  lam|w  thanh|r  ruong|zf  ^re|r  lan|s
^pham|zr  ^kho|w  long|x  thot|zs  ^bac|zj  ^hong|r  ^gian|s  lip|s  ^bop|s  ^de|z
^lung|f  lu|w  xam|zr  ^^my|x  ^kho|z  ^giam|zx  nhom|zr  buou|w  hec|s  sap|j
^ngoan|j  ^tang|zf  ^^nhan|z  ^ech|zs  chap|j  dum|s  binh|x  ^cuoi|wx  choc|zs  gam|zx
^gat|j  nem|z  ^ddau|zr  nhu|wr  hue|z  ^tat|j  ^qui|s  ^da|x  chau|zs  ^phap|zj
mau|zr  ^trut|s  ^ram|zf  ^^trua|w  ^ton|zr  thia|f  ^thang|wf  ^be|r  nhot|s  ^ghe|z
uot|zj  ^^truong|wf  cuon|zf  ddon|z  gap|ws  dam|w  ^ngo|x  heo|s  ^luong|zf  gam|zs
toac|s  ^ddoa|s  ^ky|j  ^song|f  thung|s  ^kieu|z  rua|r  ddang|zs  duot|wj  gao|s
^ddai|x  he|j  ddui|r  vau|zr  ro|zx  ^len|f  nhut|s  gan|s  ^ddem|zj  ddau|s
^mut|ws  ^ddan|j  ^lan|wj  ^voi|f  ^tuu|wj  loe|f  ^sup|j  nhuc|s  chot|wj  ^niu|s
diu|f  noc|j  ^giuong|wf  phay|zr  ^manh|x  ^te|zj  ddun|  ^menh|zj  doi|f  ap|ws
^chao|r  chom|ws  ^mac|s  nan|wj  nham|w  ^vut|ws  thinh|r  ^but|ws  ^dua|wj  bom|x
nheo|x  nuom|wf  ^troi|s  no|wx  ^dieu|zx  ddanh|r  ^pon|z  do|w  seu|zs  mang|x
^ddu|  nom|zj  cun|x  nhuom|zs  uong|zr  ^than|r  ^bung|j  ^tap|zs  ^nhan|zs  ^ddang|x
guom|w  kenh|zf  sam|s  ^bai|j  phung|f  ^hai|s  ^khien|zr  mim|x  ^dai|f  ^mun|j
hen|zs  chet|j  khai|r  on|ws  ^lot|j  mum|x  ^tuoi|w  choe|f  trau|zs  ^hiem|zs
^mang|r  dday|zj  hi|r  tru|ws  pha|r  ^am|r  nang|j  ^nhi|j  nhong|zj  xo|wr
menh|z  ^xach|s  ^go|x  ^muon|zj  xien|z  nhon|wr  mo|ws  ^nao|x  ^on|zf  dduom|wj
^ddan|r  cot|s  kham|z  ^ghenh|zf  muc|s  ^ki|s  gioi|f  chac|s  sang|ws  nam|j
bet|zj  ^y|r  ^khau|z  chua|wr  loi|zf  ^chom|z  sun|j  ^chiet|zs  chinh|f  ^soai|s
pheo|f  ^gieng|zs  xoi|zr  ^do|wx  ^hu|s  ^bong|zs  len|r  ^sac|s  ^nga|r  ^chong|z
^vac|j  ^dam|z  ^suon|wf  ^khoai|s  vat|j  can|wf  ^pac|s  dom|f  gop|zj  hung|wf
^thang|wj  ngong|zx  dum|f  nhung|f  ^bau|f  ngot|s  von|wf  goi|wr  vanh|s  ^te|s
^lanh|f  vua|wx  ^quet|s  ^can|r  ^tat|s  cua|wj  hy|r  ^ich|s  toet|s  ly|f
^goc|zs  phiet|zj  ^va|s  ^cong|zf  mieu|zf  mot|j  nuc|wj  ^nao|j  ^rang|wf  ^cong|x
reu|z  ^so|wf  ^han|zj  che|r  ^kien|zr  rau|zf  sam|j  ^nom|z  ^leu|zf  ^mo|zx
^hoan|j  ^cuong|z  men|zf  kieu|zj  toai|s  ^tho|wr  vai|s  roc|zs  rom|z  ^nhin|j
pham|f  ^tru|ws  ^tro|zr  ^lua|j  ^seu|zs  ^gap|ws  tre|z  ^treo|f  ^nhoi|s  ngop|zj
^^hau|zj  hong|s  ^man|wj  ^i|f  nhoi|s  cu|wx  ^nhe|s  tray|zf  phich|s  ^kieng|zr
uoi|w  loa|s  ^cung|s  ^sang|f  mong|zs  ^gac|j  gac|j  ^gap|zj  huc|j  ^nep|zs
phen|f  ^muoi|zx  cay|zf  sam|w  ^son|wr  oai|s  ^ddap|ws  gieng|z  ^troi|zx  chong|r
^on|ws  ^ngam|zx  ^^yeu|z  ^to|r  ^nom|w  chop|zj  rua|wj  ^ngo|s  dung|wr  thua|r
^ddec|s  ^luoi|wx  gam|ws  lum|s  rop|wj  ang|ws  ^tuy|s  ngoay|s  o|zs  top|s
^bao|f  te|zf  ^sut|s  khang|w  dam|zs  ^ruoi|zf  ddong|r  ^xua|w  ^giong|z  dday|
treo|r  ^ben|zf  ^tuc|s  pich|s  muot|zs  ^ngon|s  sai|f  san|zf  ^tram|r  ghien|zf
ha|s  ^roi|zf  ngan|zs  ruom|wf  ^dieu|z  nit|s  ranh|x  hen|z  ^khoac|s  ddoan|r
^hoang|wf  van|wj  chech|zj  ^gio|wr  ^mo|wf  kech|zs  cui|f  ^be|zj  ^chui|wr  ^tieu|zs
ram|z  ^trot|s  khuyen|zr  ^phieu|zs  sao|r  dam|zj  ^po|z  toac|j  ^dat|ws  ^vieng|zf
ngoai|r  tieu|zf  ^boi|z  ngach|s  vang|zf  ^tuong|zf  net|j  ^thung|r  ^hao|j  ang|w
net|zs  ^luy|x  ^li|s  ^boc|zj  ^bap|zs  ^moi|zf  sooc|s  i|r  ^thoong|f  eo|f
bom|wj  ngap|s  gang|f  ^tru|wx  phung|s  ^rau|z  ^mau|zs  vot|s  ^bam|zs  dday|zx
nhai|j  xong|zr  ^cun|s  buong|ws  ^kem|s  ^khoc|zs  ^ngat|j  loet|j  long|j  ong|s
^ngong|s  ^nhat|s  nam|zf  ^mam|ws  ^pho|z  tay|f  ^gong|zf  loi|s  rieu|z  ^khoan|r
coi|r  toe|s  ^mo|zf  vuon|wj  eo|r  ngong|j  hau|z  ngay|zs  troc|s  ^nem|zs
^sung|wf  ^nghia|s  hang|s  quang|x  gau|f  ^chuong|wr  kieng|zf  thuyen|z  ^gac|s  ^te|f
^chien|z  tuot|zs  ^loa|s  ngoanh|r  ^quyt|s  ^^dda|s  von|r  ngui|r  ^toat|s  bo|wj
^mien|zs  ^^ngam|ws  tiem|zs  ^ddich|j  tiu|s  ^got|s  tre|zf  bong|zs  nai|f  ^boi|wr
^nung|f  ^ddai|s  ^buom|ws  hao|x  ^suot|zs  tem|s  ^at|s  ^hung|ws  von|s  ^toan|r
^giay|zf  nhot|j  diet|zs  mot|s  tho|zf  co|zj  ^bay|f  hac|ws  ^ot|ws  ^quat|j
cun|f  ^gian|f  ^dduc|j  ^guc|j  ^^viet|zj  ^nap|j  khit|s  gac|zs  ty|s  tram|ws
^thu|f  ngang|zr  ngac|ws  sit|s  rem|f  xo|zj  ^tam|zr  cot|wj  tia|s  ^my|f
^nhuom|zj  re|f  ^sau|zf  num|s  vac|j  ^tham|zf  ^sam|zs  ^ddam|zs  ^gioc|zs  que|f
nap|zs  ^^nhat|zs  nhom|x  giai|x  ^luc|ws  ^hit|s  lua|f  xia|r  ^ke|f  xom|zf
^thoai|r  nhon|zs  tro|zf  ^kep|j  sot|j  ^lut|j  sanh|r  mieu|z  gon|f  ^bim|r
van|zr  ^kieng|z  qua|j  nit|j  ^rung|j  luom|wj  quai|j  ^ach|s  ^buc|wj  dui|s
ngat|s  ^choi|j  chua|wf  ^lech|zj  gan|f  ^hac|ws  ^^bong|s  vet|zj  coi|w  ^phuc|ws
^mo|wx  ^ro|x  cuu|w  ^bung|wf  can|wj  ^soan|j  ^khoan|s  ^de|f  ^ban|zj  rao|j
go|z  sam|zf  ram|ws  vong|z  ^ti|s  ^phiem|zs  liem|zs  ^dai|j  ^chap|j  quan|wf
^ngao|s  ^non|s  ^coi|zj  ^bi|f  khuay|z  ^^nhan|zj  ^bon|s  vat|s  ^tui|r  xep|j
^tau|zs  ^nhot|zs  ^tuoi|ws  ^vooc|j  ^mo|f  ^chat|s  ^thua|w  ^nam|wj  ^oai|s  ranh|r
^so|z  tao|f  lop|wj  ^bun|f  ^ngam|z  nom|zf  khe|z  ^^va|f  que|zj  ^lop|zs
ddia|f  ^hu|w  ddom|r  chan|wx  ^toi|r  ^vieng|zs  tho|f  xo|s  ^thay|f  ^suoi|wr
dang|wf  liem|zf  trot|j  ddom|s  ^nhuong|wf  ^mem|zf  ^ham|x  ^xat|s  ^hac|j  ^ha|s
phiem|zs  ^goi|zs  ^tut|s  ^xo|w  no|r  ^li|f  ^nhue|zs  ^san|s  phong|zj  ^thieng|z
^lenh|z  nuc|s  ^dduoi|zs  ^ap|zs  ^duat|zj  ^co|zf  ^chen|s  ^rieng|z  chon|wf  mun|s
^hua|r  ^tang|r  ^vat|ws  ^tung|s  xue|zr  thien|zs  ^co|j  ^buyt|s  ^voi|zj  ^^khong|z
luong|zs  mau|zs  ^nuong|w  thon|zs  ^quay|zj  ^sua|w  ^chuon|zf  nhem|j  ^nho|zr  gong|j
chom|zr  ^^rau|z  po|w  mung|w  ^buong|zf  chat|ws  mop|s  sau|zj  ^rong|z  bat|wj
u|j  han|wf  ^khung|f  nhac|zs  ddieng|zs  ^nom|zj  lu|wj  ^ngam|zf  ^troi|z  ^coi|x
^hoi|z  nung|x  xat|ws  ^du|x  coi|s  ^mien|z  khinh|r  ^sung|f  ^^anh|r  oi|s
^tu|j  ruoi|zr  ghe|j  ^len|s  ^ran|j  ^trang|r  long|s  ^rung|w  ^rai|r  mang|s
^lam|zf  ^kham|w  ^phe|zs  ^tham|zs  khau|s  ^gio|w  ^kiem|zj  cop|s  trat|s  ^quan|wj
let|zs  ^vua|wj  ^rot|s  ^phin|f  bu|j  ^lac|s  ^gang|w  ranh|f  ^nhieu|zx  ru|s
^oc|s  tom|wr  ^nuong|ws  ^nac|zs  loi|r  ^va|j  ^suat|zs  ^soi|r  khieng|z  ^luan|zr
rut|j  ^chuong|ws  sinh|f  ddop|ws  cat|zj  ^hen|zs  qui|x  giay|x  ddung|r  ^ko|z
^uc|ws  ^linh|f  ^uy|s  ^gion|f  ^^nam|w  sui|r  ^ddam|zx  ^^cong|z  kham|r  ^huong|wf
^ngua|ws  ^mieng|zj  quyen|zj  ^ddon|zs  ^giac|wj  ba|r  choi|zj  thinh|f  ^ngheu|z  y|r
thoang|r  mu|s  ^ngop|zj  ^ddo|wx  ^cop|j  nhu|wf  guong|zf  quang|wr  gi|s  son|wr
^cao|f  ^sang|r  nieu|z  ^^ddong|zj  nghim|r  ^muot|ws  tron|ws  khan|zs  xap|zj  ^nghe|z
^na|x  ^trang|s  ^nghe|s  ^cay|f  ^vu|wf  thien|zr  phac|j  ^^xac|s  ngo|j  rieng|zf
choi|ws  ^hu|x  giam|zj  ^but|j  nghit|j  ^gam|w  ^chieng|zf  mo|wj  ^quat|zj  ^quay|zs
so|r  leo|x  leo|f  ^miet|zj  sa|s  ^cuoi|zj  ^be|x  ^hoi|wj  ^sac|wj  ^bam|w
lang|r  ^^tuan|zf  me|zf  ^ke|x  ^thuyen|z  gong|z  ^^pho|wr  ^kem|f  ^the|z  ^nha|j
^khoi|r  ddom|wf  ^ho|wr  ^bon|j  ^tru|w  ruoi|w  ^bua|f  ^lan|zj  nham|z  ^chuoc|zs
xoc|zs  mao|s  ^thau|z  nhap|s  tuu|wr  nhot|wj  ^nam|s  ^nay|f  ^di|f  ^huou|w
no|j  ^man|zj  khien|z  mon|w  vun|f  ^oan|wf  ^tuyt|s  ^chau|zf  nuong|z  ^gay|zj
soang|j  but|j  ^khuyet|zs  duong|wf  diep|zs  ^no|s  nuc|j  ^can|f  ^nhut|wj  gai|x
^chem|f  ^luoc|wj  lui|r  ^nhom|z  lap|j  ^vu|s  con|wx  veo|r  nham|s  ^khai|s
^xam|zr  ^^ha|f  ^^cua|r  chit|j  veo|f  ^khu|wr  ^chop|ws  ^min|f  ^tru|wf  ^cuu|wf
nhe|f  ngoam|j  nai|s  ua|f  sa|j  ^diem|zj  ddoi|zx  xoa|x  sun|s  ddom|
reo|r  loi|j  ^ddo|f  khuang|z  nghia|s  xoac|j  pe|z  ^^gia|s  ten|x  nhoai|f
hung|s  ^^nha|f  kho|zs  ddo|wf  ngap|zs  ^giong|zf  lom|z  thong|f  ^^binh|f  nhay|zf
^xiet|zs  nghe|z  ddoai|s  ^choc|j  chanh|j  ly|j  do|s  dan|x  ve|z  ^^com|w
^luom|wj  lam|zs  ^ang|w  ^rua|ws  tinh|j  ^mong|r  nghech|zs  ngay|zj  tuon|z  ^nan|ws
^khuyen|z  ga|r  ^nghiet|zj  su|r  ngoc|s  ^cu|x  nham|zs  ^doc|j  ^^nguoi|wf  got|zj
vay|zs  ^luoi|wf  ^soai|f  ^dan|wf  ^pa|f  cho|r  ^com|zs  phuoc|ws  ddi|f  ^em|s
lo|zr  ^may|f  ngup|j  cao|r  ^nhoi|zf  ^quoi|ws  ^cay|zj  ^ham|s  bay|zs  ^na|s
^^hoi|zj  than|zx  ^lai|r  ^ru|x  ^thuo|wr  ^binh|r  cho|w  at|ws  ^mec|j  ^tuy|j
tren|x  ^ganh|f  ^mong|zf  ^vet|j  le|f  ^huyen|z  vam|j  chot|zj  rua|wx  giau|zf
lung|r  ^sen|zs  ^nham|zj  ^^tiet|zs  trac|s  tuyen|zf  ddet|s  ^rot|zs  ghim|f  ^te|r
nguoc|ws  ^voc|s  cuoi|zj  ^quang|wr  huych|s  ^^co|s  ngot|ws  ^quang|x  ^long|r  ^nem|zj
tap|ws  thoc|j  ue|zr  ^phien|zf  ^phen|zs  ^cao|j  xech|zj  ^chat|ws  ^bo|w  ^do|f
^nghieng|z  ^luong|wx  op|zj  ^ki|x  loe|s  ro|j  uyen|zr  ^lan|w  dia|x  ^treu|z
^tru|f  ^^ddai|j  tria|j  nho|s  miet|zs  ^nai|j  ^tau|zf  phong|zr  ^sinh|f  ^beu|z
^ddon|ws  ^hat|ws  ^ho|f  ^^quoc|zs  buom|w  ^hoach|j  ^^ddoc|zj  ^kieu|zj  ngua|j  hac|wj
^bua|s  ^banh|f  mo|x  ^ngoa|j  day|zs  tram|s  ^sam|f  ^lac|wj  ^pe|z  ^gioi|wf
^thon|zr  ^^lich|j  khom|s  biec|zs  lom|wr  quan|wj  den|zf  hot|wj  ^ke|zj  dde|x
go|zr  ran|wf  ^dda|j  ^nat|s  khen|f  ^^moi|ws  ^vong|x  ddi|x  ^^ly|s  ^long|z
rup|s  ^cut|j  ^hoan|s  ddiu|j  u|f  biu|r  ^^du|wj  dat|zj  lat|j  ^ma|j
^^ky|f  ^chung|r  ^mai|f  chac|j  tiu|x  nang|wf  mo|zs  ^^giai|r  ^mau|zf  bong|j
^man|z  ^deo|r  ^so|f  trich|j  ^ddua|x  ^giuoc|zj  ^quay|zf  lan|x  ruoi|wj  ^nhuc|j
bon|f  ^than|s  ^lay|z  ^gio|r  ^hem|r  coi|zx  quat|ws  xeng|r  ^lan|j  thuom|zj
^kin|s  lom|wj  ^uon|z  ^dep|s  ^gay|zf  khia|s  ^thau|zs  ^xung|w  mon|wr  hoi|wx
pho|ws  ^chanh|j  ^vong|zf  ^ao|f  ^nhet|s  liec|zs  ^^nhat|zj  ram|w  ^^tu|wf  nhuyen|zx
^sin|f  ^he|zx  ^yet|zs  ^keo|f  rinh|r  mooc|s  kia|f  ^me|r  dam|j  ^thoang|s
chia|r  ^ddet|s  hap|zj  ^nghen|x  rich|s  khoay|s  ddem|zf  lut|ws  ^can|zs  diu|s
^u|j  ^tro|ws  binh|r  coc|zj  ddan|zf  rieu|zs  beo|x  ^noc|s  ^rao|j  linh|r
tuat|zs  muoi|zf  ^hau|f  ^cam|w  ^luon|w  xac|ws  bim|f  nhet|j  luon|zf  ^mang|f
^rach|s  hui|f  quyet|zj  thiu|r  hoc|zj  ^khe|zs  dac|ws  ^lun|s  xiu|f  khenh|zr
^thinh|r  ^nai|x  dduoi|wf  lo|wj  ^chom|zr  rop|zj  ^tuon|zf  ^ddieu|zr  hiem|zf  ^ven|j
^den|zf  ddeo|x  bong|f  ^tim|s  ^menh|z  ^bang|z  ^gio|f  doi|z  moi|s  ^^lo|zj
^nap|ws  khu|w  sam|zr  ^^noi|zj  ^ddin|  ^coc|s  te|zx  ^chua|ws  heo|r  ^xieng|z
ue|zs  bap|zj  ddau|zr  hua|f  ^huu|wj  niu|j  khac|j  chop|s  moi|f  ^xit|j
^rieng|zf  bom|wf  nuou|ws  ^^ddong|zf  thoat|ws  ^nhung|f  ^sam|w  xoc|zj  viu|s  ^nhao|s
o|wj  ^nay|r  ^tam|wf  ^khuay|zs  ^ooc|s  o|wf  roi|j  ^cuoc|zs  ron|w  ^ga|j
^^vu|j  khieng|zx  chui|f  ^quyt|j  ^bon|zj  ^soi|ws  mom|x  ^chip|s  xuyt|s  mu|j
trap|s  rep|zj  ^nuc|wj  ^lu|wf  na|s  ^ddun|f  tet|j  hom|s  bo|wx  ^pac|ws
^non|z  hy|s  ^dduoc|zs  ^vang|j  rung|r  ^dim|f  ^ddiec|zs  ^thuoc|zj  thoa|s  luom|zj
kho|f  ^pan|s  nhong|z  tho|zs  ^vet|zj  nua|ws  chong|x  tenh|z  dap|zs  nieng|zf
^ddang|f  he|zx  coong|s  ^khien|zs  ^guong|wj  ^bong|zr  let|j  xuong|wf  ^te|zf  len|x
^bia|j  ^phang|w  ren|z  loi|ws  ^dam|zf  ^ddanh|  ^ban|z  ^tray|zr  nghe|zx  tue|zs
^san|j  trach|j  ^rom|w  hinh|r  ^xuyen|zs  vich|s  troi|zs  ^^hinh|f  ddot|s  ddom|w
hinh|x  chach|j  ^om|zs  ^sinh|s  manh|f  quit|s  ^dong|z  ^dduoi|wf  ben|x  vi|r
^^tam|z  ^ban|zr  thenh|z  dieu|z  ^rinh|f  ^ne|z  chung|f  ^^la|j  ^tre|zx  ^ba|j
^hat|zs  thuong|zf  dong|zj  ^tuot|zj  ton|w  ^^phap|s  ke|j  ^^thanh|f  ^tang|z  ^nhanh|s
gu|w  ^kep|s  ^^nhung|wx  ^len|r  ^uon|zs  cum|r  ngoan|x  ^ddom|  ^vo|zx  let|s
ngo|zx  hach|s  ham|zr  ^nua|w  xem|s  ngom|f  ^nhan|j  ^man|zf  rom|s  phe|zj
huyen|z  ^gam|zf  ^muop|ws  su|j  ^ddoi|j  ua|ws  men|f  ^chau|zj  ddit|s  am|w
dui|j  me|s  ^^hang|f  ^my|j  ngoat|ws  xieng|zf  ^gop|zj  ^^mat|wj  ^buou|ws  lach|j
nhan|wx  ^uong|w  ^mu|s  ^uat|zs  xi|j  lui|x  vai|j  ^ne|zr  ^dan|zs  ngon|zj
^muong|w  ^mit|j  ^bat|j  quanh|j  ngheo|x  ^coc|j  ngam|w  mon|j  hac|s  hip|s
phay|z  phap|zs  ^san|ws  ^nhap|zs  ^ken|s  ^boc|j  ^^thong|z  ^^canh|r  ^gai|f  ^gao|s
rit|s  tec|s  ra|r  ^ray|zf  ^nghien|zf  lenh|zf  ^quyen|zr  ^tau|zj  nhau|f  ^ngui|wr
^say|zr  chan|wf  dau|zj  ^xen|s  ^penh|z  hom|wj  ^sua|ws  ram|s  ^doi|zj  ^pieu|z
^xam|s  ^xoi|ws  thia|s  ^tan|zr  ^au|zs  ^moc|j  ^hot|zj  ^ngo|w  gie|r  ^nhai|s
^ket|s  phen|z  ^ro|w  ^hue|z  ^nguong|wj  khuyu|r  ^nhim|s  ^tray|zf  gon|wj  xup|j
^ddui|f  ^cung|ws  cuom|wf  ddoang|r  ^^gioi|ws  gay|f  ^di|s  ^met|s  ngon|zf  se|zf
^bom|wf  ^hep|j  ^luoc|zj  lang|z  ray|s  ^buc|j  kiet|zs  ^^bo|zf  ^beo|f  mom|s
^^vang|f  chom|zf  ^xuyt|s  ^goi|wr  phet|zs  ben|j  ^^tran|zj  de|zf  ^noi|z  choe|s
^chuyen|zf  ^kha|s  ^van|x  tray|r  lem|s  cay|s  ^lay|j  hue|zj  treo|s  bo|x
^ddong|  lau|s  bim|s  ^^cuc|wj  tan|w  ^ngan|ws  ^cuon|zj  cham|wf  ^tron|zj  ^via|s
^truoi|w  ^^re|r  tum|f  ^ken|f  ^^hoc|j  ^quang|w  ^trien|zx  giut|wj  ^^truyen|zf  ^eo|s
^bieu|zs  ngau|z  hau|s  lup|s  ^thoi|r  nho|z  roi|f  ^vach|s  ^gion|wx  ^cong|f
^nhon|zs  ^duong|wf  nhinh|r  ^sao|f  ^pang|w  ham|zj  kieng|zs  ^^the|zs  ^hoe|f  ^phap|zs
^toc|zj  ^say|r  ^^cung|f  nhum|s  ddu|wf  ^kim|f  ^bon|zr  ^vet|s  bung|ws  nhai|f
^^cac|s  nhem|r  sich|j  hoac|ws  mi|r  ^dua|ws  noc|zs  ^^cap|zj  ^vang|z  ^^voi|ws
ang|s  ^gang|ws  ^ddai|  ^leng|f  ^tau|zr  ^than|wf  ^vuot|zs  ^tat|zj  ^^ho|zf  ^xao|s
^xec|s  ^bom|wj  khap|zj  ^^nuoc|ws  ^quat|s  ^^ket|zs  ^phinh|f  ^xu|f  ^re|zr  ^oi|w
^boi|ws  cham|zf  om|wx  chuoi|z  ^^dduoc|wj  ^nhung|w  ^diu|f  ^ddom|s  ^eo|f  man|zf
ot|wj  vien|zr  choi|zf  mam|zx  rum|s  ^^benh|zj  ^ddao|  ^hi|s  ^^che|zs  mun|f
^kiem|z  ^vay|zj  ^cap|j  man|wf  ^^quyen|zf  ^xoay|s  ddet|j  ^niem|zj  ^ddanh|f  ^dau|zx
^u|r  chanh|f  ^gon|j  ^xoc|zs  kech|zj  ^xin|s  khan|r  ^got|j  ^day|f  ^lung|w
oi|r  tieu|zx  chem|zx  ren|zf  uon|wx  ^chen|f  xoan|f  ^nuoi|zs  mam|w  ^mu|j
^ngao|j  ^nen|zs  ddu|ws  day|zf  ddom|zf  sec|s  veo|s  ^tia|s  ^seo|j  ^^mot|zj
^thut|j  khuan|z  ^ngop|wj  bung|s  ^sanh|s  giam|wj  ^lan|x  ^^o|w  ^^u|wf  ^^tai|f
^cui|r  nhuan|zf  son|f  im|r  lim|f  tep|zj  chom|r  ^quan|zs  ne|zj  ^phoi|zr
teu|zs  tho|s  xom|z  liem|zj  khe|f  det|j  ^gat|wj  mom|ws  ruoi|ws  ^noc|j
^chon|w  nay|s  ^bui|s  ^nan|r  ^bot|zs  xep|s  ngoac|wj  le|j  ^a|f  ^xiem|z
yeng|z  ^lo|zf  ^bung|w  rai|s  xoa|f  ^hong|s  ^lun|f  ^quet|j  et|zs  ^^nghiep|zj
^chu|wr  choang|j  ^ro|zr  ^nong|f  cang|s  thuy|f  tong|zf  ^thai|r  ^^toan|f  ca|j
bop|ws  ^vang|w  ^^te|zs  rom|ws  ^ddeu|zf  ^vung|wf  suy|s  ^ngat|s  say|zj  giua|j
^treo|s  i|s  ^^ve|zf  ^xuong|zf  ^hu|wr  chay|zs  ^ren|s  rac|j  ^^ddep|j  com|f
hi|f  ^^phat|s  eo|j  ^^van|w  ^ddang|zs  ^nhon|wf  hun|f  ^^dan|z  ^^thi|j  thoc|zs
^tac|wj  voi|wj  iu|r  sop|zj  ^ngoi|wf  ngong|zf  chuot|zs  ^be|zf  ^xuoi|z  ^xang|s
keu|zf  ^nguc|j  ^ddia|r  ^loang|x  ^thot|zs  ^^nu|wx  toi|wf  giau|zj  ddong|zr  ^nham|wf
^chuoc|zj  truu|wf  ^gi|s  khuech|zs  tay|zs  ^gao|f  ^^tai|j  ^em|z  ^^an|s  ^lot|s
^re|x  ngai|s  bun|r  ^^ddat|zs  ^trau|zf  ^to|zj  ^doi|zf  ^tot|zj  ^sam|s  nhao|x
kong|z  ^lien|zf  ^chom|ws  choe|j  ^coi|z  ^dam|wj  giua|x  nung|wj  ay|s  gap|s
sai|x  ^re|zx  ^hoai|j  chen|x  ^oi|zr  dua|s  tret|s  ^hoi|wx  ^bot|j  ^ngot|zj
^lan|zr  lu|s  ddum|f  soi|zf  ^thac|wj  ^chay|z  ^phoi|z  ^giat|wj  duoi|zs  lieng|zs
tram|z  ^buom|zf  ^tac|j  ^chot|wj  ^rom|z  dduoc|ws  bon|zr  che|zj  vy|x  muong|zx
^tong|zf  sem|s  ^phan|w  mua|wr  rin|j  bop|zs  ^^tien|zf  ^^thu|ws  ^lam|x  rut|ws
pin|s  bac|zs  ^chon|zf  hup|s  thim|s  ^hong|j  ^bit|s  ^tam|f  nguu|w  toai|j
ruong|wf  ^then|r  quo|w  nhe|x  gau|zx  nhen|zf  ^trao|s  ^chut|ws  nhang|x  lom|zr
kinh|r  rum|j  ^khat|zs  ra|s  ^khiem|zs  suot|wj  loang|s  ^ham|zr  ^tua|r  ^^su|wj
^nieng|zf  ^doi|zs  ^^ac|s  ^tam|w  ^choi|zs  tup|s  ^chuong|zj  hoat|ws  sieng|z  nay|zr
^xoan|w  ^^ddau|zf  nhuoc|zs  ^the|zf  ^^tren|z  ^^toi|zj  ^thau|zf  xeng|f  phut|j  ^uop|ws
^rang|s  ^cao|r  neo|s  ^lo|wf  ^^so|zs  chet|s  ^luong|wf  ^cua|ws  rang|s  tro|r
^^tinh|f  truon|wf  tuom|w  ^^thuat|zj  suot|ws  ^huoi|zr  ^va|x  loan|f  nep|s  ^khich|s
to|zj  ^uyen|zr  ^xeo|r  ^choi|f  han|ws  tuoc|zs  ^pa|s  xon|w  toi|f  nang|wx
^am|wx  ^reu|z  ^qui|x  xang|z  thit|s  ^gie|z  ^ron|zs  ^huu|w  ^lap|wj  ^chuong|zf
pho|w  ^^vong|f  ^phat|zs  giu|x  ^^phai|r  ^venh|z  ^oac|ws  ^po|w  ^ngoc|zs  bon|wx
^^lam|f  ^ddoi|ws  vuong|wr  ^bam|zf  chot|j  e|f  cop|zj  ^goi|zj  teo|f  ^sao|s
ghe|f  ^sau|zs  tang|wf  ^khau|zs  voi|zs  phoi|ws  not|ws  ^tram|s  nghech|zj  ^day|x
khay|zr  sai|s  ^neo|r  ^lua|ws  ^buot|zs  xon|zs  ^ri|f  rui|f  ^soan|s  ^duong|wj
quap|ws  ran|zj  ^am|zf  ^^can|zf  ^^sau|z  ^chot|zj  mo|j  ^^bat|zs  ^^hoi|zs  ^gut|s
^^hom|z  lem|j  ^long|s  von|wr  ^het|s  ^xien|zr  huyt|s  ngom|zr  ^chan|zf  xue|zf
^ti|j  len|f  ^phieng|z  ^nhao|f  ^^sam|s  ^co|ws  lon|wf  ^tang|wf  rap|ws  xuan|zr
gui|f  lat|wj  ^ke|zf  ^xua|f  nhong|x  ^^quan|zj  ^quan|zx  ^tua|wj  duoi|zx  hech|zs
^^chien|zs  ^ban|zf  vo|zs  ghem|s  ^cho|w  song|x  ^bu|s  ^tep|s  ^^thu|r  ^^thoi|wf
^huong|zs  dau|zx  cum|f  ri|x  ^hoac|wj  xum|s  tip|s  ^^hoang|f  ddep|s  map|zs
^quay|z  xom|zr  ^^the|zr  nhay|zr  son|s  ^ngong|zx  bin|j  ^quang|wj  trun|f  ^lung|wr
^ngau|z  xuc|wj  ^ua|ws  ngai|x  ^thang|f  ^ddon|zj  ^chi|f  tanh|j  ^rai|s  ^vay|zx
^nghenh|z  giat|ws  cong|j  ^trieng|z  ^xon|zs  loat|s  ^op|zs  ^phu|w  ^cay|j  ^ddam|wf
^^ddi|  khot|j  ^ben|s  ^xien|z  nay|z  ^hach|j  lon|wr  ^dat|j  ^^ban|s  ^^ddang|
^quan|zr  ^nhay|j  ^^xuan|z  ^^luat|zj  ^chep|s  ^ngac|ws  giap|zj  ^ta|x  ^cuom|zx  xoang|f
thi|r  ^hon|ws  ^^vi|f  oet|s  oach|s  cac|ws  ^hoi|s  ^ngai|r  rang|wj  ^^vat|zj
^nguoi|zj  um|s  ^ranh|r  ^dduoi|z  may|zr  ua|s  ^chang|z  ngo|f  ^trau|zs  pho|f
^^chi|s  ^um|s  bom|z  ^vung|j  ^qua|j  du|wf  chai|x  ^coi|zs  ^sot|s  khenh|z
^soat|s  buon|w  reu|zj  ^dduoc|ws  khe|zj  loang|j  ^^dde|zr  bang|z  map|j  ^^ao|s
^vo|zf  nhep|j  ^thay|z  ^bien|zf  ^^chu|r  ^^nguyen|zx  ^^trien|zr  ^loet|s  diec|zs  ^khoet|s
nich|s  soai|f  nhui|f  run|r  ^ddoan|r  ri|f  ^ddao|s  ^ddo|wf  ^men|zs  ^them|zf
^leo|f  vung|wj  ^ngau|zj  chem|x  lai|f  i|j  nhiec|zs  lang|wx  ^nhy|x  ^day|zf
^thoc|s  ^loi|x  tray|z  ^gie|r  lo|ws  ^mang|ws  xuyet|zj  khue|z  ^kem|x  nhat|ws
truong|wj  miu|r  ^vo|w  khap|zs  ^men|f  ^^len|z  nhay|zx  ^thuan|zs  than|zr  ^^san|r
^xiu|s  ren|s  ^^ngoi|z  kit|j  ^oi|zs  ^rang|f  ^ngong|z  ^phim|s  ^^chip|s  ^phui|r
^dam|zx  ^toai|j  ^cu|wx  ^^me|j  ^ddinh|x  ^trat|s  phung|wf  cui|j  ^^dda|f  thui|r
^chai|f  ^giay|s  nung|s  ^up|s  mom|r  ^^thuong|w  biu|j  ^tum|s  vang|z  ^che|x
^lai|f  ^chieng|z  ^cui|s  guoc|zj  ruoi|wr  ^trac|j  ^ruot|zj  ^^ho|zj  ^xui|s  lup|j
^he|zf  diep|zj  ^chong|f  ^mang|x  giong|s  ^troc|j  ^lanh|r  ^thim|s  inh|f  ^^cau|zf
tua|w  phinh|s  ^vot|j  ^khuan|zr  ^^u|ws  ^vo|ws  ^^ddinh|f  tot|j  ^ngang|zr  ^^vo|wj
hooc|s  ^tuu|wr  giem|zs  be|j  ^mo|x  luom|wf  com|wx  ^cuu|w  ^thao|f  lay|zr
^chung|wf  ^ddom|zs  khia|j  xac|j  ^^ky|r  ^ban|zs  oanh|s  ^dday|zs  ^kach|s  nac|ws
^vo|s  go|wf  ^^bi|j  ^ddoa|  ^ninh|j  nhen|j  ^so|j  mong|f  nhoe|f  ^quang|zf
^gheo|j  ^doi|x  hoe|f  ^long|w  huyen|zx  ^^dduc|ws  ^hom|f  ^nghien|zs  ^xeo|s  khuot|ws
^^trieu|zj  uon|w  trien|zx  ^voi|w  suong|wj  ^mat|j  bau|zs  ^ran|w  nhun|x  ^nham|r
vin|j  chuom|wf  si|f  tui|j  ^^luan|zj  ^sai|r  ^ke|s  ^^lai|j  ^te|zr  ^^dda|x
xuoc|wj  ^coi|j  nhan|j  ^chuc|j  ^tru|s  khan|f  ^ho|ws  ^chua|wr  ^bung|s  co|zf
tranh|f  ^^thang|s  ^thinh|s  com|ws  ^lan|wf  tuan|zs  trap|zj  ^nuc|ws  lung|wx  ^^tet|zs
^chung|w  pham|zf  thuy|s  thay|r  chui|x  ^chay|f  niet|zs  uc|j  ve|f  ^chom|f
suu|wr  ddot|j  ddung|x  nham|zr  ^riep|zj  ^ru|s  bec|s  ^^hoa|s  ^no|r  ^nuom|wf
^^co|w  ^nien|zf  a|x  ^^lan|zf  ^^phong|f  ^^chuyen|zj  ^pham|f  ^^bo|zj  ^ngay|s  nhon|w
e|j  cung|j  ^^duong|w  ^ra|s  ddom|z  ^khop|ws  ^ddan|ws  ^lu|f  ^^tre|r  ^^chong|zf
^hong|zr  nhon|ws  phinh|r  bien|zf  ^^ddinh|j  ^go|z  khoeo|f  quat|wj  ^ai|r  ^thanh|r
muong|zf  ^^truoc|ws  khuu|ws  ^tieu|zf  ^quac|ws  ^ddut|s  ^guoc|zs  ^tac|zs  sam|zj  ^ngo|ws
sam|zx  nghanh|f  gau|zf  tieng|z  ^rem|f  ^sung|w  ^xen|z  ^vot|wj  ^chit|s  ^lieng|zf
^cop|zj  xuy|s  ^qui|r  ^^can|w  chon|zj  ^^cuoc|zj  qui|r  phet|s  ^pi|s  ^ddiem|zs
^tung|j  tan|wf  ^due|zj  ^ddong|r  hue|zf  se|zj  ^sut|ws  pieu|z  ^luon|wj  lu|f
ngam|f  ^^su|wr  kham|zs  tham|zx  ^ma|r  tung|wr  ^ham|w  ^hang|w  ^^nan|j  roc|j
nanh|j  xau|zr  ^chanh|r  tenh|zx  ^^dden|zs  ^khoang|ws  ^ba|x  ^luyen|zs  lang|wf  ^dam|zs
^^dung|j  ^pam|w  thung|j  ^^cu|w  biu|x  chom|wr  nhan|wj  ^giam|zs  the|f  ^^tong|zr
nhu|s  ^^mua|f  chu|w  nghiu|j  ddam|w  leu|z  ^gau|zf  ^duc|wj  ^soi|wr  do|z
^ddung|r  tua|r  ^diem|zf  ^^toi|z  ^ranh|x  ^xung|s  ^^thuc|wj  ^xiem|zf  cha|j  ^phong|z
^^tuyen|zr  khung|wf  ^^xay|z  cam|wj  ^ddieng|zs  ^^nghe|zj  hay|zf  ^hach|s  ^^si|x  ^^nang|wx
sen|r  ^choi|ws  bech|zj  phot|j  ^mau|zr  ^gam|z  ddu|s  ^nhanh|f  ^than|zx  ^tue|zs
co|wr  nep|j  ^ruoc|zs  ^pi|f  le|zr  ^vut|s  ^choi|s  quen|f  ^^niem|zj  rum|f
^niet|zs  ^ddop|zs  ^^trinh|f  ^ghien|zf  ^bon|z  sung|x  ^^be|s  ^nham|f  diem|zs  ^dam|j
^ma|f  ^kip|s  nhut|j  denh|zf  ^sop|zs  xue|z  ^nau|z  ^^hanh|f  ^^hue|zs  ben|zj
kho|w  ^^van|ws  ^gat|zj  ^lep|s  ^bieng|zs  ^^sieu|z  vang|wf  oe|j  ^mec|s  ^ghim|f
^po|f  nhanh|f  ^^vao|f  sat|zj  ^mot|s  ^^ddao|f  bau|z  ^^dduong|wf  ^^phu|s  ^lan|zx
ria|r  tiu|j  pheng|s  ho|w  ^gay|zx  ^nai|f  ddang|wx  ^lang|wr  ^rom|zs  ^huoi|zj
^^le|z  ^dung|wr  ghiec|zs  ^giuong|w  ^bom|z  trom|z  thong|zr  ngoang|wf  lau|zs  chap|wj
^roc|zs  ngot|zs  vang|r  ^kon|z  ^dam|zj  ^vat|wj  con|r  ^choi|zr  ^cuong|zs  ^nhu|x
quach|s  ^hau|zs  ^khuoc|ws  ^ngu|j  un|r  ^^ddien|zj  ^vo|f  ^^thien|z  ^thuot|ws  ^ngoi|s
nguay|zr  ^xom|z  ^^hung|f  ^^an|zs  ^mon|w  cup|j  ^vuot|zj  ^si|r  so|ws  ngau|zs
^lom|z  ^mut|s  lia|j  ^^ddo|zf  ^gion|z  ^rep|zj  ^ngup|j  kem|zf  ^^so|w  ^trien|zf
^^hieu|zj  neo|f  ^giat|ws  ganh|f  ^^tri|j  ^bec|s  ^ngoi|wj  ^ngap|s  roi|r  quynh|f
quit|j  ^hot|ws  ^gioi|f  ^tanh|s  dot|wj  ^^vien|z  o|ws  ^vuon|wj  ^hen|z  ^xoi|w
po|wf  ^mong|zs  ^choang|r  nhon|zr  ^vang|s  nia|x  ^xao|r  ^nhich|s  ^^tao|j  xua|wr
^gam|zs  vap|zj  ^lao|s  thung|x  ^cay|zf  ^gon|z  ^^tuong|wj  lon|j  ^nhung|s  ^voi|z
thang|r  ^hen|f  ^suc|j  ^dong|s  ^phan|f  set|zj  ^^ma|f  ^hun|f  nhip|s  ^me|zf
chan|j  ^^chuan|zr  ^thieng|zf  vuoc|wj  vo|j  ^le|r  ^khap|zs  hum|s  ^sin|s  ^^ddo|r
^^tich|s  ^^ddoi|zj  hoi|f  ^^qua|r  than|w  ^po|wf  ^sui|f  ^theu|z  ^ram|zj  ^^ban|j
^o|s  ^rut|j  ^^nguyen|z  ^mo|ws  cut|ws  ^sui|r  ^nhom|f  ^ty|f  ngoac|j  ^^ddoc|j
^hieng|z  ^^ty|r  muong|wf  thut|s  bon|z  ^muc|s  xao|j  ^xoi|s  ^lan|s  ^khien|z
^kem|zf  ron|s  khay|s  ong|x  ^lung|r  ich|j  chum|j  ^yem|zs  ^^tra|f  noan|x
ruc|ws  kenh|zx  ^^giam|r  ^la|r  roc|zj  tuan|zx  ^loi|f  xang|s  trinh|x  chin|r
^^chat|zs  ^buou|w  lon|zr  ^van|zf  nhiu|f  ^^bi|s  ^^hop|wj  ^bap|zj  ^to|s  thom|f
^pong|z  ^luych|s  ^lieng|z  gioi|zj  ^truan|z  ^yeng|z  so|zf  ^^tot|zs  ^^huu|wx  ^mot|j
^^xa|x  ^^bai|f  sip|j  ^bia|f  pia|s  luc|ws  ^khen|z  ^^dde|zf  ^^kho|s  ^mien|zj
^hot|s  ^quang|f  ^khap|zj  ^xieu|z  ^dao|f  chenh|zr  ^mim|r  ^u|f  ^than|w  lam|zr
^khom|s  ^sat|wj  truyen|zs  ^cuoc|wj  nhop|ws  ^vut|j  hon|r  in|r  ^giom|z  bay|s
^ang|r  ^^phuong|w  ^nau|zx  truyen|z  nhuy|j  nganh|j  ^luon|zf  khanh|r  ^khen|f  ^guong|zf
^ddeo|x  ooc|s  ^tang|s  ^^cap|zs  ^^chuong|w  lom|wx  ^dam|w  ^nhong|zj  ^van|ws  ^giai|x
xac|zs  ngoac|s  ^^tinh|r  ^^an|w  go|w  ^chin|r  ^ay|zs  ^^la|f  ^^hoa|f  ^^chet|zs
^kuop|zs  ^ro|ws  com|z  ^xo|zj  ^vuong|z  ^^cach|s  dduong|z  ^^son|w  dia|f  ^^thong|zs
^tet|s  ^banh|r  ^^bang|r  nheo|s  ^^quang|r  bup|j  ^day|zs  cuon|z  lao|j  thep|zs
con|ws  ^hu|f  go|zf  ^xao|f  ^hoet|s  khu|s  nhach|s  ^^ddieu|zf  ^tho|z  chung|wj
lieng|zj  ^lat|ws  ^lu|wj  ^tro|w  ^han|ws  ron|wf  rip|j  ^ngo|wf  ^cung|w  ^ddong|j
ngop|s  gu|s  lat|zs  ^mieng|z  ^^luong|w  ^oanh|s  ^gam|wj  ^giat|s  ^^ddao|j  ^lang|wf
^ngat|ws  leo|j  huong|wf  ^thiem|zr  lieng|zr  ^khuoi|zr  ^ddung|wj  ^^dung|wj  leng|s  ddenh|zx
^^ddau|zs  boi|zr  ^^tay|z  xu|s  choi|r  ^kien|zf  ^pe|s  khung|wj  ^bay|zr  ^^ba|f
^^tu|wr  ^khan|f  ga|s  ^len|zf  ^hang|s  ^^ong|z  ^huoi|zf  ^kham|r  ^thang|r  son|zf
^nuot|zj  ^^ddoan|f  phiu|j  ^tieng|z  tret|zj  ^^tieu|z  huy|s  ^dat|s  ^com|f  rua|ws
et|s  ddo|wj  ^khat|ws  toc|j  ^le|zf  ^^tang|w  ghi|f  nhang|wj  ^sen|z  ^hoi|wf
^bua|r  nguay|zj  ton|wr  ^cha|s  thet|zs  mem|f  ^thong|f  ^^hai|r  ^hi|r  to|zf
^^goc|s  xieng|zr  dum|j  khao|j  ^man|ws  ^et|s  ^nho|wx  bien|zx  ^giooc|s  ^lang|wx
ddop|zs  ^nhung|x  ^mo|wj  ddac|s  ^ddam|w  ^ddun|  ^^bao|r  xo|zs  ^ac|ws  ^sung|r
chu|f  ^^luc|wj  re|zf  ^lo|zs  ^^ddo|z  lun|j  ^^luong|wj  ^^chi|r  ddan|zx  moi|w
^ru|f  ^^quyet|zs  ^xom|zf  nghe|f  ^^thoai|j  ^cham|zf  ^phot|zs  ^^giao|s  ddat|zj  phuoc|zj
^dan|x  man|s  vong|zs  ^^phan|z  tom|x  gay|r  ep|j  ^^van|zs  ^nham|zx  ^^chan|z
muong|z  chuong|wf  ^man|s  ^muoi|zj  ^nieu|z  ^hooc|s  ^^ddoi|zs  ^khia|s  ^xoan|ws  ^vien|zf
^ddot|ws  ^xuong|wf  ^lua|f  ^uot|ws  reo|s  ^he|j  ^^may|s  ^ko|w  ^hec|s  dac|wj
op|j  ^^mat|zs  ^nghen|f  ^lit|s  ^ka|f  ^non|w  lua|x  anh|f  khuyu|j  ^lo|s
^xac|ws  ^gan|z  ^loi|w  ^ro|zf  ^thenh|z  ^ngoanh|r  ^tit|j  ^ha|r  giem|f  ^tia|r
^oai|r  ^nam|z  ^^gap|zs  nghet|s  quay|zx  ^^sat|s  ^^hien|zj  quap|wj  ^choe|s  ^me|f
teu|zf  tay|s  ^khieng|z  ^mam|w  ^^thu|w  ^ddung|f  ^hung|s  ^phich|s  ^^uc|s  nhanh|j
xon|r  ^do|s  thuoc|wj  ^tup|s  ^xoa|x  ^^them|z  ^^nhan|zs  quac|ws  hong|zs  ^ddiu|j
^rau|zf  ^oan|s  ^ngua|wr  biu|f  ^buon|w  ^no|w  ^^viec|zj  ^ua|w  ^ho|wf  ruc|s
^vua|wx  ^ngo|zs  ^chop|s  giao|r  ^nan|wj  ec|s  bua|wj  dien|z  ^xan|ws  ddang|wj
^tuyp|s  ^nhun|s  ^sa|r  ^phenh|z  nheo|f  ^^tac|s  ^pha|j  ^vay|zr  ^chan|ws  ddong|f
^nap|zs  ^tray|r  ^bun|r  ung|wr  ^nghen|s  ^rup|s  phau|zr  rat|ws  bam|wf  ^truoi|zf
^^gai|s  ^heo|f  ^trong|f  bon|w  ^^bo|zs  ^cach|j  ^nanh|f  ^^song|zs  ^^van|zx  mieng|zr
^yeu|zr  ^^vu|x  phieu|zr  li|j  ^pu|s  ^gi|f  ^^chot|zs  uynh|s  ^^sac|ws  ^pot|zs
^dot|zs  ben|f  ^lui|j  toang|s  ^^vo|z  ^^biet|zj  ^^ngo|wf  ^si|f  dang|w  ^loong|r
^luy|j  ^mo|zs  ^kieng|zf  ^triu|x  ven|zj  ^^ngheo|f  teo|j  ^mu|r  nam|zj  ^^noi|s
^xoe|f  vec|s  ^^manh|j  ^hanh|x  nghiem|zx  ^ngo|f  nguech|zj  ^phu|wr  ^tuoc|zs  ^^hon|w
^gui|f  chim|s  trau|f  ^nan|w  thoan|w  ^let|s  ^gai|x  ^^that|zj  ^in|r  ^he|z
^xau|z  ^thot|ws  ^tham|wr  nhui|j  hui|s  ^ron|wf  ^^tan|z  ^trom|z  ^thien|zs  xay|zr
^^cuoi|zs  phenh|zf  ^gong|j  khu|f  ^^nhieu|zf  von|z  ^hip|s  ^khuong|z  ^bo|wx  phom|r
^ri|r  quo|wr  ^chon|zj  ^^nong|z  tua|ws  ^^ddan|f  ^^tran|zf  ^^con|f  ngoa|j  ^ra|x
^hop|ws  ^chia|x  ^xop|zs  ^muoi|w  lech|zs  bau|f  ^pa|r  ^cam|z  u|wf  ^nhay|s
tanh|s  ^mang|s  ^^ddac|wj  ^kiet|zs  bua|j  ^tan|wf  ^rap|s  ^ap|zj  heu|zf  ^poc|s
^bung|ws  khi|j  ^^dday|zr  ^chan|wf  ^^gi|f  ^muot|wj  ^^chung|ws  bec|j  ^^ddem|z  ^gu|f
^^hong|zf  ddua|s  ^^xuat|zs  xenh|z  nhong|zf  nhuong|wx  ^lung|wf  cac|j  ^ho|w  ran|wj
toang|f  luoc|zs  ^^pho|zs  xoam|f  ^thieu|zr  nhe|zx  sit|j  mon|zf  ^^trang|ws  chum|s
^^cuoi|wf  ^mo|s  ^tieng|zr  ghe|zf  ^^thuoc|zs  lao|r  up|j  pon|z  ^^lon|ws  ^heo|s
giam|w  ^ddo|w  ^mun|f  ^nang|zx  ^^ngoc|j  ^^cuu|ws  sua|j  ^min|j  uc|s  ^ddat|s
^^huong|ws  ^bieu|zf  ^gac|zs  loang|wf  ^^le|zx  goi|ws  van|wr  ^^dich|j  gau|z  ^^cau|z
^cut|s  tien|zr  ^thiep|zs  ^^nen|z  ^sai|s  vem|j  ^phon|zf  ^^bang|wf  ^toi|w  trien|zj
gan|j  ^ngam|zs  ^^moi|wf  ^^nhap|zj  dem|f  ^ro|j  vang|wr  ^^pha|s  ^^ddo|zx  ^^nhac|j
ve|zr  ^vay|zf  ^ghe|j  choac|j  giac|ws  ly|r  gay|zr  voc|j  ^net|zs  phan|zr
nau|zx  chop|wj  ^^vay|s  hom|zr  ^lenh|zf  vao|s  ray|z  hu|j  ^ngo|r  ^^huong|w
^let|zs  ^^sach|s  ^peo|s  ^bua|wf  pheu|zx  ^^kien|zj  ^ret|zs  ruoi|wf  ^re|s  ^nhu|wx
chong|f  ^^qua|f  ^ga|r  khum|s  ngon|ws  ^ngau|zf  ^hoc|zs  cua|f  man|zs  ^giao|r
choan|s  ^ung|s  xoanh|f  quyen|zx  mui|r  soi|x  thot|j  ^^bien|zr  nhua|j  ^^nang|w
^nem|z  ^nua|wx  ^su|r  ^thit|s  ^vai|s  ^^mat|ws  ^bon|f  ^khue|zr  ^^lay|zs  ^ranh|f
^^han|f  ^khuech|zs  doi|zr  sao|j  ^^ddong|z  e|s  buot|zj  ^^ca|s  ^u|s  ^^ghe|z
phooc|s  ^^thao|r  ^gan|j  ^^khoa|s  ^xo|r  ^^thua|wf  ruong|zx  bop|zj  ^^tho|w  ^dday|
^hieu|zf  lac|wj  pang|w  ^thao|j  ^sa|s  oc|zj  ngiep|zj  ^rop|wj  ^dduc|wj  ko|z
^phi|r  ^^pham|zr  ^^tuyet|zj  boi|r  ^giam|wj  suc|wj  ^^quan|zf  ^chun|f  ^^tuoi|zr  ^meu|zs
tam|zj  seo|f  ^cat|zj  kit|s  ^^so|wr  sec|j  chao|j  ^^phi|s  oan|wr  ^tho|f
bang|ws  ^huyen|zx  tim|r  uom|ws  ^^hoan|f  ^vong|z  ^say|zs  ^^a|z  ^^pham|j  ^bim|f
^to|zf  dec|s  chien|zf  ^^mac|j  dong|zf  reu|zs  ^nen|zj  ^the|zj  ^dang|j  ^that|s
^lon|wf  ^^hop|j  thua|f  phang|r  quam|ws  ^^than|z  bia|s  ^^thai|s  ^lim|j  ^nhan|w
guong|wf  nhot|zj  ^^phu|j  ^^than|zf  ^nau|zj  ^^se|x  ^^kham|s  ^^tap|zj  ^^quan|z  ^^giau|f
^^tim|f  lan|j  nhom|r  ^^lap|zj  ngu|ws  ^^choi|w  ^^tuong|wf  ^giam|zj  gu|wf  ^^bieu|zr
rung|wr  xoach|j  ung|f  cau|f  ^dduong|z  ^^long|f  le|s  hem|f  that|s  ^nuong|z
^triem|z  tru|w  luon|wf  ^gan|s  kin|f  lau|f  ^kheu|z  hich|j  ^^ddoi|z  ^ngon|zs
treo|j  ^ui|r  hoam|ws  ^^khach|s  ^nom|zf  ^kham|zs  nhiu|s  tum|r  ^hua|f  ^hy|s
xenh|zf  ^tom|f  ^^to|zr  lua|wx  troc|zs  ^thua|wr  ^choe|f  ^^chon|j  ^nhong|z  ^^ron|wj
^^tu|wj  ^dden|s  troi|j  ^hon|wf  ^tho|zs  cho|zr  ^^ung|ws  ^^duc|j  lu|wr  ^khua|f
^bo|wr  ^thua|r  ^^ddon|w  ^^chuc|ws  mech|zs  ruong|w  phon|wr  ^bi|x  ^dien|zs  ^dop|ws
^^tinh|x  ^kia|f  ^quay|zr  ^nhun|f  ^^nhu|w  ^no|zj  ruom|zj  ^^am|z  ^hue|zf  ^^tieng|zs
enh|zx  me|zs  ^nguom|wf  ^^lien|z  ^tuot|zs  ^^ca|r  ^^ddon|s  ^^huyen|zj  ^mooc|j  ^^khung|r
^suc|s  ^ri|s  ^ren|z  chuoc|wj  ^hang|zx  diec|zj  triu|f  ^cui|x  ^nhuy|j  mua|ws
queo|j  ^^bau|zf  ^^ddoi|zr  ^ddot|j  ^thuoc|wj  ^do|zx  bip|s  ngoan|wf  thech|zs  ^at|zs
^^he|f  chieng|zs  ddec|s  ^reu|zj  ot|s  ngau|zr  ram|j  ^^nen|zf  chieu|zr  ruon|ws
au|zf  da|r  ^hap|j  ^rong|f  ^liep|zj  ^^vung|f  ^^nghia|x  ^pho|f  ^thon|zs  ^doi|f
^lay|zf  nhau|r  ^ten|s  ^^hai|f  ^^cam|r  ^^trong|j  ^van|wr  met|j  ^^tuyen|zs  ^khan|r
^bap|s  ^khuoc|zs  ^mong|f  ^^mo|wr  ^^hai|j  ^xi|r  ^^muon|zs  qui|j  ^^co|z  xut|s
pac|ws  ^^dai|f  ^de|r  ^hong|z  nget|j  ^^phuc|s  hu|wr  ^lien|zx  ^giau|zf  ^che|r
^^loi|wf  sa|x  ^dau|s  ^num|s  men|s  ^luong|zs  ^sen|zr  ^dday|f  tuech|zs  nua|w
som|f  chenh|zf  chenh|zs  long|zr  ^thia|f  ^^vo|x  ^^quy|s  huenh|z  xen|r  ^gio|z
^thai|f  ^po|zf  tho|ws  ^^troi|wf  ^^giu|wx  xech|zs  ^liem|zs  ^^tang|wj  ^dui|f  ^mam|zx
^^vi|j  ^^banh|s  ^ngat|wj  ^^dan|zx  ^suon|z  ^dan|wj  ^rat|s  ^gau|f  vop|j  ^cot|s
^xuong|ws  ray|x  ban|wr  nguyen|zx  ^non|x  tuenh|zf  ^^hoi|zf  kieng|zx  ^sun|j  hoang|wf
^lop|wj  ^^mien|zf  dich|s  ^siem|z  tro|zs  ^cau|s  ^^mung|wf  ^lia|f  ^luu|wf  ^^nang|wj
riu|s  ^ddung|w  cui|wr  ^^gio|wf  ^^thang|ws  khong|zf  ddum|s  ^doi|zx  ^^ky|s  ^coi|w
^^noi|zr  thuan|zr  ^thoi|zs  ^^thuy|r  ^xin|r  cot|j  mup|s  ^khuyen|zr  heo|f  sang|wf
^^truong|wr  ^phay|zr  thuot|wj  ^^buon|zf  ^long|zs  ^^ddang|r  ^^hoa|j  ^khuu|w  ^^biet|zs  ^ray|s
cha|x  ^^loi|wj  ^van|wj  thai|x  ^ki|j  ^ro|r  ^^phan|zf  trit|j  ^lam|w  kieu|zs
enh|zf  khuyen|zx  toet|j  ^nhon|wr  ^ddom|r  ^^liet|zj  don|z  ^nua|s  ^nam|zf  thin|f
thung|w  ^dia|x  xang|wf  ^^nhin|f  pham|w  roc|s  ^hich|j  ^bang|s  nieng|zx  ^chu|ws
^^bat|zj  xinh|x  mich|j  ^pao|s  ^phet|zs  ^khan|zs  ^^gon|f  nan|s  ^dom|f  mao|x
^^nghe|zf  cham|zx  ^phu|x  ^vat|j  ^cang|wr  ^^que|z  ddu|f  ^^bien|zs  ^^tri|s  bam|wx
^^dung|f  xe|zf  ^^chuyen|z  ^^ddia|j  ruom|ws  ^tro|zs  ^xeo|f  ^xoay|f  ^^sua|wx  ^cui|f
chinh|x  ^^cao|s  ^that|j  don|ws  ^hui|j  ro|s  ^^ngan|z  ^^gui|wr  ^ruom|wf  ^^kien|zs
^^khoi|wr  ^veo|j  ^lom|x  ^^lua|wr  rop|zs  ^^hoat|j  tem|f  gioi|s  ^^mien|zx  so|zx
bieu|zx  ^ro|wf  ^^bien|z  dua|x  ^^nghi|j  vanh|x  liu|r  xo|zf  lam|r  ^oet|s
ro|wf  ^^sai|f  ^vich|s  ^neo|f  ^ran|s  ^^van|zj  ^^ddao|r  ^thiec|zs  hoac|s  ^phay|z
^tro|j  nhoam|f  ^^dien|zx  ^ngai|s  ^^tui|s  sua|s  ^^ddich|j  tech|zs  poc|zs  ^^ddap|s
theo|j  ham|wf  ^^hung|w  ^xep|s  re|zs  ^han|wr  ^kit|s  toai|f  toe|j  ^nhu|f
^rang|wj  ^^tro|wj  ^nan|zf  ^^co|zr  ^mao|f  de|zr  ^nha|s  vot|zs  ^kum|w  ^thu|wj
tach|j  ^nham|zs  deo|j  buong|wr  ^trao|j  ^^khanh|s  tran|wf  lom|zs  phoc|zj  ^^cho|wf
trau|zr  ngoeo|f  ^leu|zs  ^^tien|z  ^^xau|zs  ^^gap|wj  pi|s  ^ruoi|w  ^ong|s  ^rum|f
^^mo|w  ddup|j  ^voi|wj  bap|s  ^sieng|z  ^^o|wj  chang|j  ^^ke|r  ^cang|s  ^un|r
^^tuc|j  quanh|s  phoc|s  ^am|wf  ^xoc|s  ^kinh|r  ^^ddinh|r  ^goi|z  ^mi|j  chon|ws
ddop|s  tranh|j  ^^dien|zj  not|j  ^chu|x  ^ron|s  am|zj  thuong|zr  ^trien|z  che|s
cang|zx  rit|j  nghe|zs  ken|z  ^dang|wf  ^^bao|x  thao|f  ^^tuong|wr  ^nhut|s  oach|j
quet|zs  ^soong|j  ^^toc|s  ^^chao|f  ^lanh|s  luyen|z  ^ly|f  ^sooc|s  xe|f  ^net|j
nhoi|wf  ^^cup|s  ^sap|j  ^^niem|zf  tro|wf  ^^hiem|zr  ^co|wx  giop|zj  ^^bo|zr  ^ngam|f
^quy|j  ^dduom|wj  ^sap|zs  ^^giay|f  ro|r  khi|f  ^nhang|ws  ^bay|zs  ^tom|w  nhom|zf
^vay|r  ^^thuy|j  tro|zx  ^va|r  muom|zx  uong|wf  ^lu|r  man|z  ^^ddang|s  oc|j
^on|s  ^^xu|wr  ^^luu|w  ^^quan|r  bum|f  buc|s  ^ngot|s  lom|zf  hang|wx  ^^tich|j
^^buoc|ws  ^tri|x  nhuong|w  lua|w  ^thung|s  ^^suc|ws  ^xap|zj  ^hoc|zj  ^vit|s  diem|zf
^nhe|f  ^truyen|zs  lap|s  ^nhac|zs  ^chung|wx  ^khoat|s  ^^toi|ws  ^truat|zs  ^quenh|zf  ^xit|s
cho|zf  ^^ddoi|wf  ^^cuong|w  ^^phe|z  hot|j  ^^ddat|wj  hay|s  khet|zj  ^gia|j  ^^chua|w
ddung|  ^oan|wr  buu|wr  ^bat|wj  guom|wf  ngom|r  ^tun|x  ^nhon|j  oi|wf  ^giac|ws
vau|zf  ^que|r  ^boi|wf  phuu|w  ^^tieu|zr  ngan|j  ^giau|zj  nhiem|z  ^^trai|s  ^^hop|zj
^me|zj  dit|s  ^chach|j  ^luong|zr  ^cua|wj  ^chien|zr  ^ngoai|s  bua|wr  tuoc|wj  khenh|zj
nghiu|r  ^choi|zf  ngom|s  sop|j  mec|j  nhiep|zj  ^^phong|s  giap|zs  ^chang|wf  chum|x
^^thuan|zj  ^^nien|z  khu|j  ^coi|s  ^^tro|wr  ^chau|zs  ^nho|j  ^^tau|f  ^din|s  y|x
^^ddo|zj  ^^ve|s  ^hac|s  mu|w  theu|zr  ^ngao|f  ^pe|j  dinh|j  ^dui|s  xung|wr
^nguyen|zf  ^^can|zj  lui|s  san|zr  ^do|z  ^ron|z  ^^minh|f  coi|wf  ^^cuoi|ws  ^thien|zr
^^thuong|wf  ^^dde|zj  ^ddeng|  ^thoong|j  ^y|f  ^^thue|z  su|f  nom|z  senh|zr  ^pho|wf
^com|ws  ^nghanh|f  gu|j  loang|w  ^^ca|f  ^^mat|zj  nhay|z  ^cap|ws  man|wr  ^ran|zj
nhang|wr  chui|s  ^^noi|w  ^^sap|ws  ^khuan|z  thung|wx  lich|s  ^^ddien|zr  mieng|z  ^liem|zf
^chuc|wj  xai|s  ^ngoan|x  non|zj  ^^tat|zs  ^^bac|j  ^^lua|s  thap|j  ^ue|zr  en|z
^^chan|zs  xia|s  ^^cai|s  ^phoi|wf  quan|f  ^triem|zr  lon|zs  ^noi|f  hieu|zf  ^^ke|z
dip|s  ^^bat|ws  ^^hat|s  luy|s  ^nhan|r  ^^ke|zs  ^^xin|j  ro|ws  ^lon|z  uc|wj
thui|s  ^troi|zf  ^diep|zs  xan|s  ^^moi|z  ^luom|zj  hay|z  gie|s  ^bung|r  ^ngach|s
chen|j  vay|j  keu|zs  ^^nhiem|zj  ^^go|f  ^hom|s  ^quanh|f  ^^rong|zj  du|ws  xui|j
ec|j  ^chao|j  vam|z  gio|z  tic|s  ^^gan|zf  ^^mang|j  ^teu|zx  ^^tin|s  ny|f
bet|j  thanh|j  ^keo|r  ^^vung|wx  ^truong|wj  bep|s  ^khuu|ws  hieu|z  chay|zf  ^^khuyen|zs
^lon|j  dinh|f  trot|ws  nhiem|zr  ong|r  sot|zj  ^toet|s  ^nguoc|ws  ^voi|wf  giay|zx
^ke|j  sum|j  ^^vai|f  ^ghe|x  ot|j  ^nhiem|z  ^^chau|z  ^loe|s  xuyet|zs  ^ngoay|s
^^ddu|r  khia|f  gom|z  ^^cay|z  ^^qua|s  ^^vuc|wj  ^^ban|f  ^^so|zr  ^^nho|r  diem|zj
phoc|zs  xam|f  ^^ve|zj  ^^ngoai|f  bo|ws  von|zf  ^ram|z  ^le|s  ^yem|zr  ^ca|j
^^viet|zs  chuy|f  ^^ddat|j  ngang|x  ^nhuom|zs  ^^phuc|j  ^tham|zj  ^^nay|f  ^ram|w  ^nhu|wr
mic|s  ^vi|r  hoe|j  ong|zr  lop|j  mec|s  ^ngut|s  ^^ngoai|j  nan|zs  trao|j
^^le|zj  xy|f  ^phach|s  ^lam|zs  ^^mon|z  ^gioang|w  ^tiet|zj  ^thoang|r  ^thinh|f  ^roc|zj
^^thay|zf  nop|zs  ^^thu|wr  chut|j  ^voc|j  ^ngu|wf  trang|z  ^buc|s  ^cuon|z  ^nhut|ws
troi|w  en|zf  ^truy|j  lop|s  ^^bac|ws  ^^tai|s  ^^mau|f  o|r  ^^thuc|s  ^ngan|zf
hop|s  muoi|z  ^pooc|j  giat|j  ^vem|j  ^lang|z  nhon|s  ^soc|j  ^toi|zf  ^^cua|wr
^^kiem|zr  ^^trung|s  ^khet|s  hoai|r  ^xot|zs  ngun|r  ^hung|wx  ^vai|x  ^poc|zs  ^^ky|x
^phong|zf  ^koi|w  vuc|ws  xiem|zr  gam|wf  ^liec|zs  ^riec|zj  ^giut|wj  ^^ha|j  nhut|ws
^vang|wr  ^tui|j  ^loe|f  trieu|z  ^xem|s  ngau|zj  kheu|zf  an|zf  ^duoi|zs  sang|w
^chui|f  choet|j  ^^no|wj  ^pieng|z  nong|r  ^sanh|r  ^gan|f  ^nay|z  ^^tuong|ws  se|zs
hoanh|r  ngum|j  doc|s  ^nang|j  ^^giong|zs  ^dat|zj  ^quan|wf  ^nua|r  sin|j  ^ngo|zx
^phen|f  nhit|j  ^roi|zx  ^boc|ws  soat|j  ^^ddung|s  ^bam|zr  ^om|wx  ^thom|f  ^loi|s
^^tra|r  ^uong|zr  ^thet|s  ^^mach|j  ^^he|s  tam|f  ung|wf  nhoi|zj  phut|wj  ^luon|wf
rom|f  na|r  ^^ddu|  ^^nuoi|z  toay|s  dde|zx  ddui|  ^vat|s  ^dday|r  ^^khuat|zs
^lum|wf  o|f  ^^bai|j  nhieu|zr  ^le|zs  ^nhuong|w  ^^lap|j  ^ngay|zj  nich|j  ^^san|z
^^ddanh|s  dut|s  ^then|f  ^nang|wf  ^^phuoc|ws  ^giot|s  ^mom|zf  ^^noi|zx  ^^tuc|s  goc|zj
^^cu|wr  song|zf  rat|wj  leu|zs  nguyt|s  vo|zr  ^cam|wf  nhua|s  ^^trang|j  rao|r
^ho|s  ^ten|x  ^ghe|r  thuy|j  lon|r  ^^chay|s  ^nhon|s  triem|zr  ^bu|wj  ^seo|s
^phoc|ws  ^nan|f  ^^huyen|zf  quau|j  ^^toan|s  ^^gia|r  ^ghet|zs  ^vuc|j  gio|ws  ^^xep|zs
^mom|r  ^oa|f  diem|zr  ^rung|r  ^^loai|j  ^voi|zf  ^giuc|j  nguoi|wr  ^cong|s  bai|r
^vin|j  ^vun|j  ^^cam|zs  ^bet|zj  ^^on|w  ^heo|r  ^^cham|zj  khay|zs  re|s  ^noong|j
san|zs  ^^nhan|zx  ^ngap|zs  ^^tien|zs  nong|j  ^khang|w  lien|zx  lai|r  ^^duyen|z  ^lech|zs
^^that|zs  ^dai|x  ko|w  ^^chap|zs  ^xuy|s  ^ddieng|z  ^cheng|s  ^^tro|f  ^^bo|r  ^^gia|f
^no|wx  ^^dau|z  ^^mon|s  ^ly|r  ^ram|j  ^truong|ws  ^^au|z  ^hao|x  dac|j  kep|zs
^^nao|f  giat|s  ^^vap|zs  nang|zs  ^^duong|wx  ddien|zx  ^rieu|z  choet|s  ^^giup|s  ay|z
^ngo|zr  uot|zs  ^theo|j  nghet|zj  ^vo|zs  ^^ghe|zs  ^cheo|s  ^^thieu|zs  ^^suong|ws  ^lay|zx
^ly|j  ^tay|s  oi|ws  ^^uy|r  ^san|zr  ^kho|wf  ^lo|zr  vam|wf  ^lim|f  hen|zj
^^chong|zs  ^^trieu|z  ^^hut|s  ^xep|j  nhai|r  khoam|wf  ^^giap|s  ^^toa|r  ^su|s  cua|s
^chop|wj  ^trap|zs  ^^bac|s  ^ngang|s  ^bum|f  ^^tuong|w  ^huyen|zs  ^^mi|s  ^chuom|wf  ^sop|zj
^ot|wj  ^kem|zr  ^roong|f  ^^biem|zs  ngoc|zj  ^nhu|wf  khang|j  lot|ws  ^re|zf  bem|r
^chech|zj  ^rat|ws  ^heng|z  ^^nganh|f  hoanh|j  ^ddia|f  ^^hanh|j  ^nhe|zx  ^non|zj  nhoen|r
^xom|zr  hoan|r  beo|r  phat|ws  suong|zf  may|r  phe|f  ^^tinh|s  ^tip|s  ^xeng|f
^xip|s  ^^som|ws  ^say|zj  ^linh|r  ^van|wf  ^tech|zs  ghen|f  khan|ws  pe|s  ^lui|s
em|zs  ru|f  ^^tuoi|w  kien|zf  ddoc|s  tre|s  ^suy|s  ^^nguon|zf  ^cun|w  hu|wj
mun|r  nhe|zr  ddon|  ^^kich|j  ^kieng|zs  ^^kho|zr  ^^ddoan|s  ^vien|zr  ^^la|s  ^muong|zs
senh|z  khop|zj  ^tram|wf  ^quay|zx  ^^cang|f  ben|zr  ^pia|s  da|f  ^phom|z  kach|s
^tray|z  vac|wj  ^^moc|zj  ^^ddan|  tria|f  ngoac|ws  kien|zr  cam|f  ^loang|j  nginh|x
kheo|f  ^me|zs  ^khuong|zs  ^han|zs  ^^roi|zs  ^von|z  ^^ho|zx  ^tong|wf  ddop|zj  binh|s
^tuon|z  ^^uoc|ws  dot|ws  venh|zr  cham|zr  soi|zr  ^^gay|z  ^^thau|zf  ^^so|wj  thich|j
^cay|s  ngon|f  ^thoa|s  ngheo|j  ^^giua|wx  ^quen|f  ^nhot|ws  ^phang|wr  ^bin|j  ^tum|r
khuy|j  ^xia|r  ^^mau|s  ^ooc|j  ^^khac|ws  hau|zr  quot|ws  ^toong|f  ddem|zr  ^reo|r
^^loan|j  bau|zj  ^^giay|zs  ^got|zj  cho|f  ^tung|r  ^toe|s  ^po|zs  pham|zs  ^e|f
^an|zf  ^dup|j  ^ba|r  ngum|s  nuong|wf  ^song|zf  ^trooc|s  a|z  nhuan|z  ^tec|s
^^oi|w  ddin|  ^trieu|z  ^^lac|j  ^noc|zs  theu|zf  ^roong|s  pay|z  ^^chi|j  ^dden|r
pham|s  ^dan|zr  ^cop|zs  khuyech|zs  ^ham|zj  nhech|zj  ^^khac|s  phon|w  ^^ddung|wf  ^man|zr
ong|wf  xam|zf  chang|r  ^nhap|j  ^^thiet|zs  ^trem|j  ^xieng|zf  nheu|zf  ^^phuong|wf  ^loc|s
ram|f  ^cham|wf  hap|j  tua|s  trum|s  ^quang|s  thuan|z  ven|r  ^^nang|z  ^dung|wx
nho|f  ^chung|f  ^^vot|wj  ^^ddao|s  ngan|wf  ^tre|s  do|wj  ^truu|wf  pheng|f  ^cho|f
^huyt|s  xiec|zj  ^^loc|zj  xuc|ws  ^^hon|z  phop|zs  ^xoac|j  trang|r  trao|r  ^^choang|s
^mum|x  ^ben|zj  ^^giam|s  ^then|z  ^^tham|w  ^^xuong|zs  ^xau|f  ^rom|f  moi|zj  ^xu|r
^tuan|zx  tan|j  ^chang|w  ^^nghiem|zj  ^toa|s  ^duoi|zx  ^rit|s  nhoam|j  ^^di|j  ^chenh|zs
^vau|z  ri|s  ^^kieu|zr  cho|x  ^^tham|r  ^^kiem|zj  dai|s  ^^sach|j  tuoi|zs  ^^duoc|wj
khang|r  dao|s  ^ruong|w  ^tuy|r  trot|wj  ^^lieu|zj  ron|wx  ^^nhay|r  son|wf  ^^pho|s
ngenh|z  ^^coi|wr  hoay|s  ^^mua|w  ^go|zf  ^^co|wf  ^rop|zj  ^cac|ws  ^phec|s  ^hau|zr
^nhop|zj  pong|z  ^^ten|z  xuong|z  ^rai|f  tria|r  ^^day|z  nhau|zr  ^muong|z  khap|s
ach|ws  ^vay|zs  ^thoc|j  ^muon|zf  ^^luot|wj  ^chu|f  ^^thang|w  ^sun|r  rip|s  ^ot|zs
^^boc|zs  ^dan|zj  ^^ddinh|  ^con|wf  ^cuon|zf  dien|zs  ^^be|f  ^^het|zs  seu|z  ^^cung|x
^po|s  xoet|j  phun|s  ^sao|x  ^^ddam|r  ^ngang|f  ^^lu|x  ^^lua|wf  ^phen|z  ^^phan|zs
xeo|j  sum|f  ^^hang|j  ^que|f  ^en|z  thai|f  ^quyen|zj  long|zx  ^riu|f  ^sam|j
^^trang|w  ^vinh|f  ong|w  ^^cuop|ws  ^^soc|s  ^^thoat|s  ^noi|j  ^nhuc|s  ^van|zr  ^go|w
^chui|x  um|f  gianh|r  do|wf  ^ti|f  ngoao|s  ^khoi|ws  ^^ton|z  ^mun|ws  ^^ddoan|j
quach|j  ^chinh|f  ^^phut|s  uoi|wf  phon|wx  ^khu|ws  ^my|s  dong|x  ^noan|x  han|r
^^vien|zj  ^muong|zf  pac|s  ^sang|w  ^^cuc|j  khang|ws  nenh|z  tuot|ws  ^song|w  ^trung|x
^mom|ws  ^then|j  ^^dden|  ^^cai|r  ^^go|wx  ddau|f  ^lon|zr  ^nich|s  ^^lam|z  ^vop|j
^gam|s  ^ddum|f  tha|s  ^trec|s  ^vang|wf  uon|z  ^^cui|x  nhay|f  ^nuc|s  ^xan|z
dden|r  ^^kieu|zf  ^phiet|zj  ^ddoa|j  ^senh|zr  rua|x  uoi|z  bang|wr  ^xoc|zj  dua|j
^^an|z  ^loi|zf  nguon|zs  ^huyet|zj  ^^hoi|r  ^^canh|s  pic|s  ^^hoach|j  nhoang|j  ^^xuc|s
hen|zr  ^gong|z  ^^ngo|zj  ^^tuyen|z  ^suong|wf  chenh|zj  ^rom|ws  ^^nhi|j  ^^he|zj  quam|wj
^xe|zj  liep|zs  ^^khang|s  ^nhum|s  ^^truong|w  xinh|r  coi|zf  ^buong|w  ^gai|r  ^bep|j
dam|wf  oat|s  ^dich|s  vec|zj  xien|zf  ^^thon|z  ^^ben|z  ddu|w  ^muong|zx  ^go|wf
^^ddoat|j  ^tap|s  ^khac|j  xap|s  mau|x  ^^khan|zr  con|j  ^ne|r  mo|zx  ^ui|s
voi|s  truat|zj  top|zj  ^phang|r  ^^phien|z  ^lau|zj  giui|s  ^khot|zs  ^chuyet|zs  sooc|j
^^mai|x  xen|z  ^^dang|s  loi|wr  giuoc|zj  ^^bong|zr  ^^cot|zj  ^vam|j  nhoay|s  ^ngoat|j
^^von|zs  ^^vuon|wf  ^^tho|j  ^loang|wf  ^thop|s  ^o|f  che|zx  beo|j  ^^co|zs  ^gu|j
^kau|z  quang|j  ia|r  lay|s  ^^vong|j  ^ghap|zj  ^^can|s  ^dang|f  ^choc|s  ngiem|zj
^^tam|zs  da|s  ^mang|wf  ^hung|wr  mem|s  ^^ich|s  ^^lanh|x  ^cung|j  ^^ngu|wx  ^gom|ws
^^cai|x  lu|j  bun|w  chuoi|zf  e|zj  ^troc|s  ^ddia|  ^^dden|zf  ngat|zj  ^tot|s
^^ban|zr  ria|j  ^nghenh|zx  ^^nghi|r  ^ran|zf  ^nhay|zf  in|s  ^hiem|zf  ^ngich|j  ^^ba|s
^doi|z  nu|wr  ^nhe|x  ^^no|zr  ^soong|s  ^suyt|j  ^re|zs  ^bim|s  ^buoc|zs  mem|z
^^guong|w  ^sao|r  ddu|wj  ^khuyech|zs  ^kon|w  lon|w  ^^han|j  ^mam|zj  ^top|s  ^thiem|zf
danh|s  ^nha|r  ^dde|j  binh|j  con|wj  xu|j  ^ro|s  ^^ddam|zf  ^^vuong|w  e|zr
^^man|ws  ^quanh|j  ^mia|r  pao|s  nac|s  ^thoi|w  ^tem|s  phong|zx  not|s  den|z
^^xet|s  ^hong|zs  ^phuong|z  ^mieu|zf  ^nhan|zr  ^cha|j  ^nam|zx  hiem|zj  ^ghe|f  ^a|x
^^thach|s  tieu|zj  gem|z  ^rong|zx  ^bang|j  ^uon|wx  ^nhan|wx  ^bip|j  ^^nhiet|zj  hup|j
^chay|zs  ^^thien|zj  nay|x  ^nguyen|zs  ^^ruou|wj  om|r  veu|z  ghe|zj  no|ws  hue|zs
^pham|zf  gam|zj  ^^it|s  khan|zf  ^rap|ws  teu|z  nhay|zj  ^bong|zj  ^choc|zs  ^^net|zs
^^hieu|zr  ^^chiem|zs  phuon|ws  hang|ws  ^^anh|s  ^^song|s  kiu|s  ddan|z  ^tho|zf  ram|wj
^moi|s  ^huot|zj  ^pung|s  ^^hat|j  ^^tiec|zj  mip|s  ngheng|z  tru|wj  ^ay|s  ^nghi|f
^ngoc|s  ^^xung|ws  ^chuenh|zs  ^^thu|f  lay|f  ^dduom|zr  ^^ga|f  ^^toa|f  ^^nhiem|zx  ^huan|zj
sung|j  nguoi|ws  ^sen|f  ^loi|ws  hon|zr  ^^hap|zs  ^^o|zs  huych|j  ^^quai|s  no|zs
ca|x  ron|f  ^ren|zf  ^meo|x  tiep|zj  ^^yen|z  ^tran|s  phay|r  ^kho|zs  ^^coi|f
^tho|s  ^^mai|j  ^^bao|j  ^^tan|zs  ^bich|j  ^kho|f  ngoi|zj  com|zf  ^ngua|f  ^lao|r
^nget|j  ^ro|wx  ^sieu|zx  ^suc|wj  ^^ddai|f  lien|zs  ^na|j  gia|j  ^duan|zx  ^lem|s
^nhai|f  ^xai|s  thoat|j  khat|zj  ^^to|zs  ^ddu|s  goong|f  nhan|zr  duong|z  ^xinh|s
^nay|zr  ^^cung|ws  ^bop|zs  chiu|s  gong|r  ^pho|w  ung|wx  ^do|w  ^cam|wj  pap|s
^^be|zs  ^^khau|zr  ^pa|j  ^^chep|s  ^nhau|f  ^ni|j  ^can|wj  xui|f  ^nhun|x  ^ngong|j
^pin|s  lan|wr  ^^sy|x  ddinh|x  ^^ngan|f  nghep|zj  phanh|r  ^ut|j  nhop|zj  ^go|j
^son|f  ven|z  man|r  gup|s  ^gom|z  ^^quynh|f  ^chua|wf  dday|r  ^^tho|zr  xup|s
uon|wf  ^tre|z  mop|zs  ^nhoong|s  ^nach|s  ^^kiep|zs  ^ngheng|f  ^suong|wj  ngung|s  ^^co|f
lu|r  ^^mau|zx  ^dday|zj  sin|r  ^^vung|x  ^ang|wr  tren|zr  ^^phia|s  ^ra|j  ^biec|zs
tau|z  ^dot|zj  ^^kinh|s  ^^thap|zs  hoet|s  ^ngong|zf  ^cho|zf  ^oan|r  ^^kiem|zs  say|z
^nghieu|z  ^^tien|zx  ^puoc|zs  ^^ddau|z  cheo|r  tren|zj  khua|ws  trui|x  ^et|zs  ^pon|zf
^^thieu|zj  ^ly|x  ^lay|zr  cha|s  ^^quan|s  sech|zs  ^^uong|zs  ^vo|j  ^nham|w  uych|s
tron|z  uoc|wj  nhui|r  ^koi|z  ^xin|j  ddiem|z  ^hau|z  ^^nang|ws  ^senh|z  te|x
^nhon|z  ^than|zr  ^mom|s  ^nhot|wj  ^^long|z  ^sep|s  ^^ddua|  ^^chua|wx  do|ws  vap|s
^no|ws  tua|wf  ^my|r  ^^hiem|zs  ^to|wr  ^sun|s  ^trap|s  ^ve|f  dden|z  bua|ws
^lo|ws  ^xum|s  ho|wj  ^hi|f  quynh|s  ^put|wj  ^^day|j  ^pac|j  xoi|wr  ^pang|z
^nhiu|f  do|zf  ^von|wf  ^truon|wf  ^vy|j  ^xiu|r  ^^dau|zs  ^leo|x  ^^cua|w  ^lau|zs
^^mat|s  pinh|r  chien|zj  ^^cham|w  mung|r  ^thap|j  bieu|z  ^^tam|zf  ^^nguoc|wj  chien|zx
^ngan|zs  ^che|j  tong|j  am|f  san|x  cooc|s  len|zs  u|wr  ^^nua|wx  ^nguoi|w
^cuoi|z  khen|s  ^^yen|zs  duong|ws  ^loong|s  giam|z  ^^me|z  ^^huoc|ws  ddia|  ^phau|zr
^^lao|f  ^kheu|zf  ^nhay|zr  ^^xang|w  ^^nghiem|z  rong|zs  nhien|zj  ^^ddang|wj  ddui|x  ^ghenh|z
thuong|ws  thot|zj  the|s  ^^bong|z  ^^phan|zj  thong|zf  ^^rat|zs  choai|j  hom|zx  ^nham|s
^chet|j  booc|s  ^^cham|j  ^tieu|zx  ^lum|s  ^^chu|wx  ^^ho|zr  ^lon|w  khu|r  ^^chu|s
nhop|s  ^tanh|j  ^^muon|zj  pet|s  nhang|wx  khom|j  ^^te|zj  ^^gianh|f  ^^keo|s  keo|x
^^nai|j  ^^thu|s  ^ddoong|  sop|zs  den|zs  then|zj  ^truyen|zr  ^^goi|j  gon|w  ^ray|z
ren|zj  ^ddui|x  ^chac|j  ngieng|z  ^buong|ws  ^ran|wf  ^^am|zs  ^khanh|f  ^^lo|z  ^men|z
^ne|j  ^lu|s  tun|r  ddan|w  ^xeng|r  xom|f  thu|wf  ^^gio|r  ^^buon|z  tiem|zr
gan|wf  ^han|wf  ^may|j  do|zj  qui|f  beng|s  tum|j  ^^muc|j  ^cham|zr  huo|w
^^tu|ws  ngheo|s  ^vang|x  nhiu|j  ^^rut|s  ^^cam|zr  ^^thay|zs  ^^kem|s  ^tin|f  ^bo|x
^ong|x  ^^con|w  ^ddem|zr  ^nghien|zx  ^ram|f  ^chan|wx  ^chai|s  ^tram|ws  ^^moi|zs  ^^trong|zf
^^ddang|w  ^^tac|ws  ^^phu|r  ^nhao|j  ^poong|j  ^^cha|r  ^so|ws  ^^vinh|x  ^nhung|ws  du|s
ui|s  ^lat|wj  hoang|wx  tau|s  chan|zj  ^pec|s  de|x  ^nep|s  tru|wr  ^tau|z
lop|zj  ^^nguyen|zj  ^^beo|s  ^ddi|f  tom|w  ^^li|s  ^^huy|r  xu|w  bong|x  ^huc|j
^^uu|w  ^ngon|zf  ^enh|zx  ^^chiu|j  loong|f  ^cang|ws  khao|s  ^puch|s  ^xenh|z  ^nung|w
^^van|j  xo|wf  ^^tu|r  vuc|j  ^^loi|zx  via|x  ^^phan|s  ^^diet|zj  ^liu|s  ^quet|zj
rup|j  ^con|zr  bieng|z  lay|zj  ^^cat|s  ninh|s  ^^khoi|r  ^choan|s  ngo|wr  ^^mun|j
tram|zx  phuoc|zs  ^^phan|r  ddach|j  ^^cho|wj  ^^huong|wr  ^^the|r  ^thech|zs  ^sit|s  han|zx
^^ben|zs  sang|wx  ^lia|s  ^^dinh|s  ^lang|r  san|wr  trong|r  ^^an|zr  huyen|zs  ^son|s
^sua|s  ^^chum|f  ^cheu|zf  nghach|j  ^e|s  ^chot|s  ^lam|wf  phien|zr  ^^chan|wj  ^leng|s
^map|zs  ^^hien|zf  pham|z  phi|j  ong|wj  ^ruong|zf  som|w  ^huoc|ws  ^^ddien|z  tren|f
ruoi|zs  ^bau|zs  en|zr  phan|w  khang|f  ^^ap|s  huyen|zr  ^buot|zj  ^^phung|f  ^ngay|zs
mua|j  khau|zf  ^^vua|wf  ^siu|f  biep|zj  quam|w  ^nho|zs  ^chuon|z  ^^thich|s  ddoi|j
no|f  ^day|s  vip|s  ^^phep|s  ngech|zs  ^^nhan|f  ^^giac|s  ^lui|r  ^^ki|s  ^soi|zj
met|zs  quan|w  ^bu|w  vinh|s  ^ruong|wf  ^^lang|w  ^khet|zj  ^^danh|f  ^hay|z  ^phon|z
^^chieu|z  ^he|zs  ddet|zs  kung|w  gan|zs  ^muom|zx  gua|wx  ^^ddung|j  banh|j  quo|wf
pho|zf  run|s  chiep|zs  ^loa|x  ^nhom|zj  ^^may|zs  cho|zj  khuong|w  ^pit|s  ddang|j
^xo|s  thui|j  ^keng|r  ^^buc|ws  phieu|zf  ^thum|f  ^^ddau|  dac|s  phuc|wj  trung|r
^hom|wj  rom|zj  phe|s  ^^thuong|wr  ^coi|r  ^khao|s  phon|z  rom|r  gay|zs  liu|f
^nham|zr  ^^ddong|s  oan|r  ^nooc|s  phua|ws  ^^chuc|s  ^^mia|s  trac|j  ^uynh|s  hong|zx
xop|j  ^veo|s  su|wx  mom|wf  ^quo|w  ^^bao|f  ^^khoe|r  nhoet|s  ^nguon|w  ^tau|r
^bong|j  ^nac|wj  ddoi|r  ^lum|wj  thuyen|zr  ^^khuyet|zs  phec|s  ^^bach|j  ^^cheu|zf  ^^khong|zr
lem|r  ^i|s  khan|z  ^nep|j  ^ton|w  bang|zs  ^nhop|ws  ^^ta|j  ^hap|s  don|wf
^pat|j  ^vuc|ws  ^^khoan|s  trang|wf  bot|s  ^ddon|  nong|zs  ^^nhung|w  tem|z  my|s
^giu|x  than|f  ^^tuan|zs  ^kan|zf  ^^dden|f  ddiem|zj  ^^duoi|ws  kinh|j  ^ddom|w  ^sot|j
xon|ws  ^nhot|zj  nic|s  ^^dung|x  ^^lien|zf  ^cum|w  ^ua|s  doang|x  dan|zr  nhon|wx
^tep|zs  ^^thi|s  ^^ngu|r  me|zj  ^pat|s  ^benh|zf  ^^tay|zr  ^^ai|s  ^ro|zx  ^^vuot|wj
^xuoc|ws  ^dang|zx  nghi|f  ^keu|zs  ^het|zj  ^nhop|s  ^tuong|z  ^^hang|x  ^bup|j  ^bet|s
toi|zr  xong|zs  bec|zs  ^tho|zx  ^a|j  ^^ddien|zf  ^sinh|j  nam|f  nuyp|s  ^treo|j
^^viem|z  ^vong|wf  ^hua|wf  ^^vung|j  ^gay|s  tram|wf  ram|zs  ^^sam|zs  ^leo|s  ^hieu|z
^^them|f  ^xap|zs  hom|x  trung|j  ^manh|f  tep|zs  ^lin|f  ^voi|zs  ^coong|s  ^choi|r
hiet|zj  ^^them|zf  ^^xa|r  ^^thiet|zj  ^gua|wf  ^^chuyen|zs  gua|wf  cho|zs  ^^lon|wj  ^^moi|j
^^dong|f  ^^tru|wx  ^uo|ws  ^ddup|s  ^^hua|ws  ^dy|j  giai|f  ^^ddam|s  ^nhot|j  nguo|wf
^nguoi|z  ^giai|s  ^^nga|x  ^^khat|s  lung|wj  ^^soat|s  ^^hon|zf  ^^le|r  ^bay|zj  ^^toc|zj
^nhip|s  ^cai|j  ^pong|w  ^^quyen|zs  ^lam|zx  ^hung|r  ^^rap|zj  ^khau|zf  ^^do|wr  ^^mo|z
^^ghet|s  ^nuou|ws  ^^dan|zf  ^tiem|zs  ^ddot|s  xom|wf  ^thui|s  ^quat|ws  ^^luoc|wj  mam|zr
^^hoai|f  ^bet|zs  ^roon|f  ni|f  ^^nang|f  ^vuu|w  ^^trung|ws  ^^giang|s  chao|x  ^do|r
^seng|s  ^am|w  ^^khi|s  ^^yeu|zs  ^bon|w  oi|j  ^^thit|j  ^^de|zx  ri|j  tooc|s
^^lang|f  du|x  ^^phieu|z  ^nong|r  trien|z  ^^xa|f  ^^da|j  ^veu|zf  doi|j  ^^rung|wf
^chinh|x  ^dao|r  ^^bot|zj  ^sam|r  ^^dde|r  ^lich|s  phuong|wr  am|wr  ^men|zf  voc|zs
^^ddai|x  ^thuong|zf  ^met|j  meo|r  ^linh|j  ^hop|s  ^^tham|zr  ^te|x  ^mep|j  ^^khich|s
^^lan|z  ^^ddam|f  truong|zr  ^^trong|z  xom|j  ^^goc|zs  ^^nam|ws  ^chum|r  hoang|s  ^phut|j
quoi|ws  ^^khoc|s  ^ria|r  nuoi|ws  ^^tran|f  ^^nua|wr  ^nge|zj  ^^sap|zj  ^mui|s  ^quynh|s
^^gut|s  ^^boi|zf  bo|zx  suyen|zr  ^^lanh|j  von|f  ^hang|r  ^quit|j  ^^chanh|s  ^^lo|zx
^chien|zf  ^^nho|wf  ^^nhan|ws  ^roi|j  ^lon|wr  nhom|zj  ^^sam|ws  ^ngo|zf  ^uyt|s  ^^que|zs
^ton|wr  ^tuoi|zj  ^nit|s  ^cac|j  ^chuot|zs  ni|j  ^^giuong|wf  dap|s  lun|x  dach|s
^teu|zs  ^^trom|zj  ^^huu|w  ^vu|f  en|r  ^^ganh|s  ^mom|x  chuan|zs  ge|s  ^^khuc|s
^bang|ws  ^^nghich|j  ddom|wr  ^thiem|zj  ^ngoac|ws  chec|zs  dden|zj  dda|w  ^bau|z  ^coi|wx
chech|zs  ^puc|j  ^de|s  niem|zr  ^^tung|f  ^^chinh|r  ^khoe|s  ^^ep|s  ^kenh|zf  ^^mieng|zj
^tua|w  giu|s  ^dang|w  ^^trau|z  ^thoi|wj  ^tra|s  ^toong|j  ^^thu|wj  ^xao|j  thon|wf
^^bang|w  phau|zj  khuong|wx  thoi|j  ^^cong|zj  truyen|zr  ^sech|zs  ^bua|ws  ^^cu|j  ^^chua|f
^^gao|j  ^^ben|zf  ^^day|zj  ^^lo|wx  ^^ddiep|zj  ^gam|ws  kun|s  ^^chop|ws  ^tom|wr  ^xuan|zs
voi|r  ^don|wf  ^^o|wf  ^ddit|s  ^siu|s  ^rac|j  ^ddui|  ^^lop|ws  thoi|ws  ^thet|zs
^gioi|zj  nhoet|j  ngich|j  nhieu|zj  ^tuom|w  ^hua|s  sot|ws  trem|z  ^nai|r  ^con|zj
^^phu|f  danh|j  khuou|ws  dduong|zs  ^lon|f  ^vip|s  ^^ngo|j  nguoi|zf  ^^san|w  chon|w
^^giat|zj  ^cooc|s  phoi|f  khenh|zx  ^^vi|x  e|zf  ^^ran|ws  khin|f  ^chuoc|ws  ^^san|j
bang|wx  khom|wr  ^^vo|f  ^^mac|wj  ^^lo|zf  luyt|s  ^^ddoi|f  ^ddoi|  ^^han|zj  xu|r
^^cu|s  sung|ws  ^puong|z  ^^gin|f  ^^lua|wj  ^^mau|zj  ^le|j  ^^go|zx  chiem|zr  ^^cum|s
^ip|s  buoc|zs  ^^chieu|zs  ^pien|z  ^rao|r  ^suyen|zx  pup|j  xoan|s  truoc|wj  pau|zs
^^chao|s  ^quay|x  ^biu|f  ^dung|s  my|r  kieu|zx  ^rom|wr  ^nam|j  ^koi|f  ^^phat|zj
khiem|zr  ^^hai|x  to|s  ^xuc|ws  chem|z  ken|zs  ^nhu|wj  ^be|j  ^xon|w  soong|j
^put|s  ^^ddoi|zf  ^ku|s  ^^roi|zf  chac|wj  ^xon|r  ^^lenh|zj  ^^voi|wf  con|s  ^quyen|zx
^^dday|s  nien|zf  ^nooc|j  ^^ddich|s  ^^xach|s  nhan|zf  ^soi|f  ^boi|zr  pit|s  ^^tuyet|zs
o|j  ^ngoat|wj  ^^nguyet|zj  ^^ho|j  ^^tien|zj  ^^oc|zs  ^pet|s  ^^mem|zf  ^choong|j  lum|j
lem|f  an|f  ^hich|s  ^oi|s  ^^khoac|s  dao|x  goi|zf  ^^cu|x  ^ngan|wj  ^^ngung|wf
si|s  giai|s  ^^hiep|zj  le|zs  ^khe|x  ^nit|j  ^bon|wx  ^^lang|x  ^xoa|f  ^^huyet|zs
thon|j  ^toac|s  ^^roi|w  thoan|s  ^ddanh|r  ^tiu|r  gai|r  ^cong|j  ^goi|ws  ^^xoa|s
^trien|zj  dui|x  ly|x  cua|wf  quap|j  ^oep|s  choat|ws  ^do|j  ^^hieu|zs  cang|z
ngheo|r  ^le|f  ^^song|z  ^^ddot|zj  ^phom|r  ^ten|f  ram|zx  ^^chup|j  bem|f  ^^cham|zs
^khon|zr  ^^tram|zf  hop|zs  ^^trach|s  ghom|wf  ^^muc|ws  ^^loc|j  ^^quy|r  lac|zs  duy|r
chuech|zj  ^pho|ws  ua|wx  ^bung|wr  ^giem|z  mop|j  ^^hang|wf  ^^khoang|s  hoac|j  tenh|zr
ac|j  ^^linh|x  khon|zr  giong|zf  ^^ma|x  ^bip|s  ^nhem|f  ngom|zf  ^^hoi|w  ^im|r
^^giet|zs  ^guet|zs  ^rieu|zf  ^oach|s  ^von|zf  ^^phoi|zs  ret|j  ^^khieu|zs  ghanh|s  dau|zr
^^tru|j  miem|zx  hiem|zx  mon|zs  kuc|wj  ^chum|s  ^^phong|r  bay|x  ^nen|f  ngoang|wx
^^du|w  bon|wj  ^^co|r  ^^mam|zf  ^^bo|f  ^gieu|zx  ^dia|f  ddoac|s  ^^mong|z  uong|zf
^^noi|z  ^ngun|f  ^^gioi|r  lo|x  ^^goi|wj  thong|x  ngay|zf  ^^chanh|r  kham|wr  no|wf
moi|wr  ^ghi|f  ^lua|x  ^^cu|r  nem|f  ^xac|zs  ngoa|x  ^ruc|s  ^coc|zj  ^^ria|j
din|f  ray|f  xu|wj  ^^trinh|j  ^khin|f  ^^le|zf  ^^dat|ws  ^muou|wj  chem|r  ^^buu|w
roai|f  ^^ddat|s  xoang|r  rau|s  ^^thuong|wj  ^^trieu|zf  rom|wj  ^khoi|wf  ^^nong|zf  duoi|wx
xai|j  ^ua|r  ^ddum|s  ^^muoi|wf  bung|r  ^trap|zj  ^von|r  dden|s  lec|s  ^^luc|j
khet|j  he|r  ^to|j  queo|s  ^con|j  ngui|wf  tay|r  ^^nam|zs  ^cun|f  ^rap|wj
^^khien|zs  ^^sot|zs  ^doi|j  ^^xuyen|z  an|r  cuot|zs  ^quac|zs  ^chong|zr  ^kieng|zx  ^^vuong|wj
thang|f  ai|f  ^^noi|zs  ^phang|f  ^lot|zs  ^bac|wj  ^^chang|f  ^let|j  sia|r  ^^giay|zf
huong|z  thua|zj  quen|zj  ^^moc|zs  ^rue|zj  ^khua|wj  ^xac|j  ^nghiem|zx  ^^loat|j  ^^thuy|s
^^ddo|wx  ^^mui|x  ^con|s  pot|zs  sut|wj  que|x  ^chang|s  ^tranh|f  ^xoa|r  ^^lau|z
^^thap|s  trai|x  ^lip|s  ^mooc|s  pham|r  tuoi|zf  ^me|s  hoang|ws  ^dot|ws  ^^ay|zs
^sum|w  ^^chac|ws  ^ton|s  ^nhot|s  gan|wj  dua|wx  ^soi|j  gianh|s  ^genh|zf  ^^tat|zj
^nho|z  ^^tao|s  dden|j  ^^thuyen|zf  rat|zj  ^ddeu|zr  ^buom|w  ^^thinh|j  ^ran|wj  ^^su|ws
pu|w  ^dung|w  vam|f  o|wx  ^^nham|zf  ^liu|f  ^ddu|w  ^tung|wr  ngan|wj  lam|zj
^quit|s  ^^sec|s  sat|wj  ^^mai|s  ^^san|wx  ^^thao|s  nuoc|zs  ngoeo|s  ^chuy|f  ^chong|x
dong|s  ^xiec|zj  ^^ngan|w  ^^can|z  ^^nu|j  ^rung|wr  ^nung|wj  ^^toc|zs  kho|r  ^pet|zs
chep|j  ^^hao|r  ken|j  nu|w  ^lun|j  sien|z  ^goac|s  ^khop|zs  ^^kien|z  tuoi|z
^^quy|x  ^reo|s  ^^khoi|w  nhe|z  ^^thue|zs  chai|s  ^tum|f  ^trien|zs  ^o|r  ^^sua|wr
^say|s  xong|x  ^ang|z  bang|zx  ^mom|z  khoc|j  pham|zx  ^^thieng|z  boc|ws  tuyen|zj
chuan|z  ^ddoang|r  ^no|f  ^^khop|ws  tuan|zr  ^ve|zr  ^^gau|zs  sanh|j  ^ni|s  ^oat|s
^tem|z  rech|zs  ^^hoa|r  ^sua|f  ^loong|f  ^^lang|j  ^ddan|zf  ^^ddon|zf  ^^ddem|  ^xon|zj
nhe|r  ^dap|zs  ^^chan|ws  ^nhen|zf  ^^mot|zs  ^^ngoi|zf  ^thong|x  toong|f  nan|z  san|zx
^khang|wf  ^sam|zr  son|r  ^gam|r  ganh|x  ^^nhan|x  ^^cuu|wr  ai|j  ^^tu|s  ^bong|f
^ku|wj  ^^ddeu|zf  ^ninh|s  duc|ws  ^^bung|wf  ni|s  ^^ngan|ws  ^^ddoc|zs  ^^kieng|zs  ^khap|s
^khon|wr  ^^choi|zs  ^^oc|s  ^tua|f  ^xay|zj  ^^tap|j  ^^hoc|s  ^nung|x  ^bang|wx  ^gau|z
^^huan|zs  cuoi|w  ^na|r  ^^xa|s  ^^gop|s  ^nam|f  ^suong|wr  chin|j  suoc|ws  ^toai|s
voi|wr  ^chuen|zj  ^duan|z  ^^nhi|f  ^chuom|z  ^^gon|j  ^^sut|s  duong|wr  huom|ws  ddeng|
^kiu|s  ^^ri|r  ^tiu|s  ngay|zr  che|zr  ^^cat|ws  guot|zj  ^^bung|j  ^^am|zf  ^^tang|zf
^ko|wf  bop|wj  ^hinh|r  ^^triet|zj  ay|x  ^vuoc|wj  oang|f  ^au|zf  ^giap|zs  ^^thep|s
^bum|j  ^^rui|r  tong|r  ^thip|s  ^^chon|z  trien|zs  ^^yet|zs  ganh|j  ^khuay|zr  ^dding|
^suong|zf  ^^phoi|w  ^^chuoi|zs  khua|f  chat|j  ^tron|w  nech|zs  ^dde|x  ^de|zr  hin|r
^dum|f  ge|z  ^^chay|j  choa|s  ^ddiem|zj  ^dong|x  ^truyen|z  ^^to|w  chiu|f  truyet|zj
^phun|w  ^^thanh|j  noi|r  ^^kha|r  cac|zs  oi|zj  ^^lo|j  ^^hao|f  ^ngoat|ws  ^thuong|ws
^tay|zs  ^nhoai|f  buy|s  ^^lot|s  pheu|zf  ^ton|ws  ddung|w  ^en|zf  ^nhuyen|zx  ^^bep|zs
^nhut|j  ^^ddap|ws  ^^moi|zx  ^^hien|zs  ^biu|j  ^^suat|zs  thoang|ws  to|zx  dic|j  ^^quoi|ws
^phoong|s  ^^thom|w  ^^chuong|zf  ^en|r  ^ba|ws  ^^se|r  ^^net|s  ^^nhuc|j  ^nhuan|zf  ^sa|j
^^tot|zj  vieng|zx  ^ben|x  ong|ws  ngoe|s  ^^doc|j  dop|j  dden|zr  ^kham|wf  ^^ky|j
xy|r  xoat|s  xoi|zj  ^^bay|zx  ^tien|zr  ^khi|j  ^^ddieu|z  ^^buoc|zj  ^thua|ws  ^^ro|f
^^hit|s  ^po|j  hua|wx  khuong|zs  ^uen|z  ^^phat|j  miem|zf  ^quanh|r  ^trot|wj  ^khi|f
^nuong|wf  meng|zj  ^bot|s  ^^luon|z  ^^hen|j  se|s  ^gie|s  ^^tron|zj  he|zs  tham|wf
thin|s  mua|r  my|j  ngheu|zx  ^^but|s  ^vom|zf  tin|f  quon|wx  ngoay|j  chy|s
^^ddo|zr  ^^tim|s  ^^lap|ws  ^suyen|zf  ^^chat|wj  kuc|j  ^^tai|r  na|w  ^^lan|zs  ^^chuyen|zf
^^choi|j  ^^nhuom|zj  ^moi|w  ^^nat|s  ^quan|w  teng|zs  don|w  ^^ngon|z  nung|w  ^ngoao|s
sua|x  ^vau|zr  ^^trat|zj  ^^tang|r  ^nhieu|zr  bop|j  ^^sau|zf  du|r  ^nhang|w  nuan|zj
^^tham|z  rom|j  vieng|z  ^buot|ws  ^^phao|s  ^nganh|j  ^^sau|s  du|wr  ran|f  to|wr
^^kieng|z  ngeu|z  giam|j  ^^cap|wj  ghom|ws  ngeo|x  ^nhao|x  ^^huong|zs  ung|j  pia|j
^mam|zs  luong|wr  giuu|wx  duoi|wf  ^go|wr  lun|r  nguong|wf  ^tic|s  om|s  ^^ngam|zj
^pep|s  ton|r  ^xue|zf  ^tuoc|zj  ^^chua|s  ^mu|wf  ^^ngam|zf  ^kenh|zx  not|zj  ^quay|r
muu|ws  khoi|zr  khay|r  ^cua|wf  cuoi|zr  ^^ve|r  ^met|zs  ^luot|zs  ^^vach|j  ^co|zj
xe|x  ^khun|wr  ddiu|  ^^lam|ws  nhiem|zs  ngoam|f  kic|s  ^gam|zx  ^^khon|zs  ^guoc|zj
^^mit|s  ^^thoi|z  nhau|zf  ^pac|wj  ^dien|zr  ^^lay|zf  ^^luyen|zj  ^lung|wj  do|j  trech|zj
kem|zr  ghet|zs  ddonh|zj  dy|j  ^^ddau|zj  ^^oi|z  ^^tung|w  ^loa|f  ^^ham|f  ^^ngu|x
gioang|w  ^^cua|f  roi|z  ten|zs  ^^chay|r  the|zx  ^^say|r  ^danh|s  ^^luc|s  ^pac|zs
^phieng|zf  ddoong|  tun|x  ^^kiem|z  chuong|zr  ^tun|w  gip|s  teo|r  ^^boi|s  hung|r
^^don|j  ^^ddac|ws  ^^chong|s  ^^suyt|s  noi|j  ^^phuong|wj  ^rat|wj  kham|zr  ddan|wx  ^^rieng|z
sam|r  ^^ngot|j  ngit|j  ^chap|s  lanh|r  ^pham|r  ^dde|zx  ^huong|zf  ^^sung|s  ngua|wx
^put|j  ^^xi|r  dun|s  ^^lang|ws  ^dieu|zr  ^truat|zj  ^ngung|s  doc|zj  trim|f  ^^ddung|ws
^^rua|f  ^^kenh|z  ^^lun|f  ^vau|zs  ^^phoi|zr  ^giay|x  ^^o|ws  vau|z  ^cooc|j  ^^muu|w
treu|zj  ^tan|j  ^te|j  ^ddet|j  ^xoat|s  ^oi|ws  cham|s  ^^khan|w  ^^nguc|j  ^^yeu|zr
^^via|r  ^dat|wj  ^^nui|s  kha|f  ^^cay|zj  ^^phung|j  ^^dam|z  git|s  ^phet|s  on|r
^^tap|zs  huong|zf  ^^meo|j  ^^cuu|wj  nhon|wj  oc|ws  ^^ngua|wf  ^^ddot|wj  giui|j  huy|j
khe|r  ^^tru|wf  muan|z  lon|zx  ^lien|zs  ^^ke|zj  ^op|j  ^thoan|f  ^^trang|f  phao|r
ham|zs  ^^tam|s  ^gon|wj  ^pai|f  gio|zr  ^^xay|r  ^^lanh|f  gang|wf  ^nhap|s  nhien|zf
^en|f  ^^mui|f  ^ha|x  xop|zj  xuenh|zf  tranh|x  ^co|wr  ^^nao|s  ^^tuat|zs  ^^chech|zj
^veu|z  ^nu|s  ddut|j  rot|zj  ^tuan|zr  ^nenh|zs  coi|wx  trun|w  ^chieng|zs  ^ruom|zj
oi|wj  giang|f  ^^xe|s  ^ruoi|ws  ^leo|r  ^^muon|z  ^^nhom|s  thiem|z  am|zx  ^^che|z
ngan|zx  mut|j  ^lut|s  ^^tha|f  ^top|zj  ^^tron|zs  khac|zj  ^trui|f  ^pieng|zf  ^^ro|zf
^^nau|zs  ^^bam|s  ghech|zs  ^bau|zr  ^^nhuong|wf  nghin|r  ban|wf  trop|s  ^lop|j  ^^tiem|zf
uong|ws  ^yen|zr  ^^tui|r  ^^gach|j  nuo|ws  ^bo|ws  ^the|f  ^^cau|zs  ^^khoi|z  ^poi|w
nghen|zj  ^dom|wr  hi|x  ^^ddat|ws  ^choang|f  ^thong|zf  dop|zs  ^com|zj  ^^am|s  ^pot|s
tranh|r  dduong|wr  nhin|s  ^^ngua|wj  dan|zj  chuenh|zs  ^^dday|zf  oai|j  tret|j  ^lam|r
nhu|ws  ^^gio|s  khoac|ws  ^^ddem|zs  ^men|zr  ^phoc|zs  uoc|zj  ^toc|j  beu|zf  go|j
^^lang|wj  xuc|j  ^^sep|zs  ^tiu|f  ^cum|f  cuot|zj  ^bieu|z  hau|zx  cha|z  ^^ddo|s
ddam|zr  ^^ngau|zf  on|zs  ^^khe|z  ^sit|j  ^gang|f  it|j  ^phau|zs  ^^vien|zx  say|s
^ken|z  thuo|w  kua|w  ^nhau|r  ^mup|s  ^^keu|z  ^^bau|s  dday|x  ngiu|r  ^chan|j
^^ti|r  ^^sat|ws  thum|f  ^khuyen|zx  ^queo|j  xon|j  ^cum|r  ^anh|j  cham|ws  dding|
^^vo|wx  ^^ton|zs  ^^gung|wf  ^^dau|zf  ngiu|j  ^tro|s  ^^lu|wf  ^ep|j  xem|z  ^nhai|j
thui|f  toanh|f  ^bau|zj  ^pich|s  ^xoo|f  mot|ws  nhai|x  ^men|s  ^keu|zf  ^^vay|z
^su|j  em|r  bam|wr  ^^neu|zs  ^chuu|wr  ^^bu|wj  toan|j  ^nhoa|f  ^^tong|zs  ^pia|j
^^su|w  ^khoong|f  ^trot|ws  ngen|s  gat|s  nau|zr  lung|j  ^^gan|ws  ^^mo|zr  ang|f
^roc|s  ^^ngam|z  ^so|r  ^dien|zf  ^an|f  quan|ws  xo|ws  ^ne|zf  khong|f  hiu|r
hien|zx  ^khot|j  nguon|zr  uong|wj  xang|wx  khot|zs  ^^sao|f  ^^nhe|j  ^^thuo|wr  ^khap|j
ngo|wj  hin|j  vo|zj  ^^my|f  ^xat|ws  ddon|wr  ^ngot|zs  nhac|wj  ^don|w  ^com|s
^kop|zs  ^^khoa|r  ^nong|j  ^mu|w  ^^man|f  ^thoong|s  chiem|zx  ^tan|ws  nghenh|zx  heu|zs
thoa|x  ^nich|j  ^^to|z  ^^lat|j  ^lom|f  ^ria|f  ^thi|r  lec|zj  ddo|ws  ^phat|wj
sieu|zx  ^hang|ws  ^^cho|zx  ^^cuong|wx  dduong|wj  gon|wf  ^rut|ws  ^quyet|zj  ^phe|zj  ^eo|j
^^tom|s  ^dan|j  phet|j  tra|zj  ^nap|s  ^^suoi|zs  ^pooc|s  ^^ty|s  ^^thoai|s  ddem|f
phia|j  ^nuon|z  ^^ngoan|j  ^dup|s  ^pheng|z  ^ngach|j  ^^tha|r  bom|s  coong|f  ^cho|zj
tuot|wj  ^bua|wr  ^gioi|zr  ^chuan|z  ^kho|zj  dao|r  muon|zx  ^^sanh|f  ^^vi|s  ^rich|s
^^nhon|w  ^veng|f  xay|zj  ^nhuoc|zs  ^se|zj  ^ve|zs  pat|s  ^^mua|s  tenh|zf  ^kai|j
guong|z  ^quon|w  ^^banh|r  gem|s  ^nhong|zf  ^^thi|f  ^thong|zr  ^san|zf  sip|s  ^^huynh|f
^^may|z  ho|s  dien|zr  ^^van|z  nga|j  ^panh|f  gui|r  ^nan|zs  ^roi|r  ^^het|s
pheu|zs  ^song|zr  ^^tru|s  genh|zf  ^^bon|s  hu|wx  xan|w  ^^cot|zs  ^^tri|f  ^^khap|ws
ngheu|zf  ^^boi|zj  ^^doa|j  ngo|zf  ^^du|wx  lim|r  ^xue|z  ^coong|j  ngoat|j  ^^do|f
^^ki|f  ^ry|f  ^vinh|s  ^suong|z  ^^phe|zs  hun|r  ddenh|zr  ruou|w  goi|z  meo|x
khuc|j  phenh|zx  dat|zs  ^^ddon|ws  ^buoi|zj  ^^sang|f  quay|r  ^long|j  mim|s  khang|wf
^^chuoc|zs  uynh|f  ^vai|j  hu|wf  huyep|zs  ^^dung|wf  sech|zj  ddoang|f  veu|zf  ^^quen|z
rien|z  ^treu|zf  ^khenh|zr  ^le|zr  ^^lam|zf  ^kin|f  ^uay|z  dde|s  ^^uong|z  ^pua|s
meng|j  ^pau|zr  sia|f  ^nghe|j  ep|zj  khoanh|wr  ^khung|wj  ^ddien|zs  ^^ton|zf  ^^xai|f
^troi|ws  ^biem|zr  ghi|j  ^don|x  sue|z  tam|r  khom|z  ^^toi|r  nhieu|zs  ^^lieu|z
^dum|s  ^am|wr  bap|wj  hem|x  ru|wj  nhiet|zs  khoang|w  ^thut|s  ^^ddap|j  ^cot|j
^^ngon|s  ^ruon|ws  ^loan|x  ^chon|ws  ^gay|f  ^^bich|s  ^tren|zr  hang|r  zday|zj  toan|r
^ngan|wf  eng|z  ^guc|s  ^giong|f  ^che|s  gai|j  ^^be|z  ^^thung|f  ^ven|r  liem|zx
chop|zs  theu|zj  ^lan|r  ^^tiem|z  ^tran|wf  gich|s  ^^vo|wr  ^tru|r  ^chua|j  ^^nhua|wj
nham|zx  ^^lau|zj  vu|wj  ^^xam|s  uyt|s  ac|wj  ^^nhao|f  ^lu|wr  ^lieng|zx  ^cop|s
xam|j  uong|wr  xoa|r  ^moong|f  thuon|wf  ^nang|s  ^bo|wj  ^^trong|zs  ^xup|s  ^viep|zj
ec|zs  ^^guc|j  ^^tuoc|zj  thup|j  ^bac|zs  ^huych|s  sac|s  ^than|f  an|x  ddo|x
^quoc|s  ^^cang|w  ^khe|zj  ^peng|f  ^^tuc|ws  ^^luoi|ws  nghom|wj  xet|zs  nghe|zr  ^^ne|z
boan|w  ^hoa|x  ^xo|ws  ^chu|wf  mieng|zf  ^nguoc|zj  oap|j  xot|ws  ^gio|zr  eo|x
phech|zs  ^tha|s  ^cha|x  trinh|s  ^^lua|j  ^teo|j  bu|wf  ^^tong|z  ^pau|j  loang|r
day|s  ^^cang|wr  xip|j  huom|wf  xoi|wj  gie|x  roi|zj  ^binh|x  ^^thuoc|zj  giui|wr
nuoi|wf  bot|wj  ^thom|zf  ^uoi|w  lom|f  ^qui|f  gu|wx  khieu|zr  ^^cau|zj  ^dden|j
trai|f  nguon|z  rem|j  ^^se|z  ^ray|f  giu|wr  ^pinh|r  xuoi|zs  van|wx  ^^ddai|s
^no|wf  ^^ro|x  ^^doi|zj  ^lat|zs  ^^thac|s  cao|z  cho|z  ^nan|wx  ^xi|j  ^ram|ws
^^min|j  ^^liem|z  trinh|r  ^^lo|f  nun|s  nhue|zs  ^^ho|wr  ^thon|f  giec|zs  ^ron|w
^cop|ws  ^^mac|ws  ^dinh|j  ^cuyen|zj  ^so|s  ^xe|j  ^pham|s  dut|wj  ^veo|f  ^ddoong|r
mieu|zx  ru|wf  ^quyenh|zf  ^trenh|zf  lep|zs  ^suoi|zr  ^cho|zr  ^^nghin|f  coi|ws  thuyen|zs
^bay|x  ^ngay|zf  ^^troi|s  nua|f  ^thoat|j  ^^ddang|wr  thon|zx  khap|wj  ^^ngu|w  chot|ws
nghe|r  giau|z  duong|zf  ^^le|x  ^gat|s  quac|s  ^op|zj  nghap|zj  nghe|j  ^diem|zr
^^kong|z  ^mop|s  ddenh|zf  ^nguech|zj  ^triem|zx  ^ron|f  ^bop|ws  ^buong|wr  ^^sut|j  tru|x
^su|x  ^got|zs  ^^nhe|s  ^xet|j  ^^tuoc|ws  ^lam|zr  coi|j  ^ddoang|f  ^kem|zs  ^bo|zx
^^soan|s  ^ram|s  ^vung|w  ^rieu|zj  quen|zs  ^tram|zx  ^son|z  ^^e|zj  phau|zs  han|zr
phu|w  ^thom|z  ^at|ws  ^^niem|z  nhiem|zf  ^^khiem|z  sinh|r  be|zx  ^trai|f  ^cau|f
^ddooc|j  ^^hoang|r  ^ga|s  ^^trung|f  ^let|zj  ^dde|s  pua|s  ran|z  ^queo|s  ddun|j
^^phieu|zs  ^phong|zr  ^bum|r  ^^thoi|s  ^chat|j  ^ten|r  ^goc|zj  ^man|wf  ^^chung|s  ^^xo|w
^^xap|zs  ^nanh|s  ^van|f  ^^ngo|z  ^ddong|f  ^^tram|j  ngang|wr  ^ung|wr  ^cua|f  ^thui|f
^^tung|wf  ^nat|j  riet|zj  ^giep|j  ^^hoi|z  ban|zx  ^^ho|ws  ^^mong|j  ^muong|ws  ^tra|w
ca|zf  ^lum|j  inh|j  ^hy|f  ^^ddua|w  cha|wj  duu|wx  ^ang|f  troe|s  ^^treu|z
^^cam|s  that|wj  cam|wr  ^^nhon|wf  gop|j  ^^tue|zj  ^tau|s  ^^yem|zs  ^gop|zs  pan|w
^rau|f  doan|s  ku|w  gui|wx  ^^tam|j  ^bec|j  nung|f  ^^cuong|zf  su|x  ^bua|wj
^^hen|f  eu|zf  ma|wj  ^^lach|j  ^^ngu|wj  phuon|wx  nuu|w  bom|f  ^vuong|wr  phich|j
ddan|wf  ^^di|x  ^hang|wx  ^^cam|zf  ^huou|wj  tin|x  ^ta|ws  ^xen|r  ^tang|ws  ^quon|wf
^duc|s  ^de|x  nua|wj  ^^tuy|j  khun|wr  ^^gom|ws  ^^no|z  ^hin|s  pa|s  ^ku|f
^^phach|s  khoac|wj  ^^dang|z  ^dong|w  ^^ddan|wf  ^luyen|zf  noi|wr  ^^nha|x  ^^de|z  ^^cung|w
^chuech|zj  nhoang|wf  ^^hu|r  ^^chot|s  ^^nhung|x  ^long|zx  ^^ue|zs  vung|r  ^dduot|ws  po|zs
muu|wr  ^dooc|j  ghen|s  ^^khuyen|z  ^^que|f  luoi|wr  vu|wx  ^^rac|ws  ngeo|s  ^kec|s
^ddoac|s  qua|x  ^hau|r  ^ua|j  ^^map|zj  buon|zj  ^duon|zx  ^niu|x  ^^phai|s  ^^khue|z
^^tham|zs  ten|s  nhang|z  ang|wj  ^ddun|j  ^khe|s  trat|j  ^^vat|zs  ddooc|s  ^tro|wf
^coi|zr  khuoi|w  sui|wr  ^xong|zr  giop|s  ^buoi|zs  ^buong|wf  chach|s  ^to|zx  hon|wj
kem|zj  ^kang|w  ^cun|r  ^giap|zj  ^vam|z  tuc|wj  ^ngoa|x  ^dden|x  ^kon|f  ^^ung|s
xac|wj  may|zj  xua|wf  boi|zx  buon|zx  ^^khuon|z  ^^nghe|s  lon|f  ^mieng|zf  ^^ung|f
nui|f  hiet|zs  ^^khoanh|r  ddang|zf  ^^ban|zs  ^tan|zx  tay|zf  ^^moc|s  ^mau|r  ka|f
^suom|w  ^suot|ws  luyet|zj  ^^thuan|zf  ^^khoc|zs  ^^lieu|zf  xang|j  ^^truc|s  ^^sup|j  tang|zs
kiu|x  ^chuyen|zx  ^kan|f  thieng|zf  xec|j  ^nhoam|f  xoai|x  ^^mang|w  ^tan|w  ^choe|j
^nai|s  ^nu|wj  ^^cheo|s  ^trau|r  peng|r  gieo|f  ^kieu|zs  ^^meo|f  nong|zr  ^say|f
khu|wf  ^^bay|r  luoc|ws  nga|w  ^nhu|r  ^khet|j  ^lin|j  thoa|j  ^vanh|r  ^danh|j
ghem|j  ^toi|wf  ^noc|zj  gui|j  ^^dep|j  nhun|w  ^giam|j  trem|j  on|zx  cin|f
^pich|j  ^^bop|s  ^^ne|s  loac|s  ^phang|zr  ^^buou|ws  thon|zj  sun|wf  ^neng|s  nim|f
cuong|ws  ^^giang|w  ^uan|zs  chang|ws  nghem|zx  ^^et|zs  ^ton|r  ^chuoc|wj  ^mua|r  den|zj
nu|wj  ^khoac|ws  ^seo|r  kho|j  ^^hy|r  ^phung|r  non|wj  ^denh|zf  ^kach|j  thai|j
^da|s  ^oc|j  ^rua|r  ^^thoa|r  com|x  ^chem|j  ddieu|f  ^gooc|s  que|zf  ^ddo|wj
^ruou|w  get|s  ^map|ws  nom|r  ^^dai|r  ^trem|f  ^vang|r  ku|r  ^muon|ws  ddoi|
^thop|zj  ^chuoi|zr  ^^gian|r  khuong|z  in|f  ^chun|w  ^thuan|z  phong|j  ^^mong|r  khuynh|f
ddu|j  ^tan|wj  ^ddu|f  ^pua|ws  ^thau|s  ^^dim|f  tram|zr  nua|wf  ^^trai|j  muoi|zr
em|j  gon|s  ^^tay|f  ^^ghe|r  ^phen|zr  nghang|f  ^^cho|ws  ^pieng|zs  ^^khom|s  liet|zs
^^mang|f  cau|j  may|zx  ^chet|zj  ^teng|zf  ^guoi|w  cot|ws  seo|x  ^tria|f  choo|j
^^phien|zf  ^ddy|  ^do|zj  vuom|wf  quech|zs  ngoach|s  ^^nho|zr  senh|zf  ^^sung|wr  ^khenh|zj
thoac|s  pau|z  ^^dao|j  ^chuyet|zj  ^tham|zx  ^ghanh|s  ^^dung|w  ^^man|wj  bieu|zf  hom|wx
thom|zr  nhua|w  ^quam|wj  ^^mang|ws  ac|zj  ^nhan|wf  ^^giac|wj  ^roc|j  ^^ddut|ws  ^kai|f
^ngen|f  ^^long|zf  ^lieu|zs  hep|zj  ba|wf  ddi|s  ^^ddiu|j  ^ach|ws  ^doch|zs  ^triu|f
heu|zj  suong|wf  ^^bung|f  hiem|z  ^sec|j  on|wr  ^^tiec|zs  ^^tram|w  ^trang|z  chay|zr
nheo|j  khan|wr  pac|j  ^bu|r  bua|w  ^^cang|r  giot|s  ngien|zs  phem|zf  xiep|zj
^an|ws  ^cheng|z  ^^am|zr  ^chuoi|zf  ^chen|j  ^dduoi|zf  mua|wf  phut|ws  phon|s  ^chuy|s
^^tham|zf  ^^mam|z  ^mien|zr  ^buoi|wf  ^^loi|zs  ^lom|zs  dam|r  ^^bui|j  ^nhai|x  ^xenh|zr
^tenh|zf  po|s  ^^linh|s  ^^tro|zr  nhunh|w  ^^nham|ws  ron|zx  thuon|zs  gam|r  ngua|w
^^chung|r  ^tom|x  ^phooc|s  ^^men|zs  ^ne|zx  ^^ddang|ws  ^xien|zs  ^buom|z  ^nhong|x  viem|zx
^^tiep|zj  di|r  ^^ne|zr  ddeo|s  ^poi|zf  ^^doi|wf  ^cuong|wr  troi|zr  khung|s  ^^ddam|
ken|r  ^^sac|wj  ^nieng|zj  ^la|zf  ^^lay|z  phe|zr  ^trinh|x  gop|ws  ^boi|zx  ^ruoi|zs
^^ddinh|s  ^teng|zs  moi|wj  ^dding|j  ^ven|z  ^^sanh|s  an|wf  ^vong|zs  nec|s  ^^hut|j
hem|zr  rui|s  khen|zs  ^^cong|zr  ^tham|j  ^^rui|f  ^sau|zr  heng|z  chuon|z  chan|f
^^tam|wf  uong|z  ^giut|s  ^song|zj  chung|j  henh|zf  ^kan|w  ^hoang|ws  ^mua|j  ^nguoi|wx
^chan|r  ^xam|f  ^vieu|zj  quo|zs  gam|s  voa|x  ^^xong|z  ^pung|f  choen|f  ^ec|s
^^chim|f  ^^sen|zs  than|zs  guc|s  suong|zs  ric|s  ^^tho|wf  ngenh|zx  ^tenh|z  ^khui|f
loang|f  koach|j  ^^thuc|j  gom|j  hoan|w  ^venh|zr  ^tuen|z  ^ba|zs  ^coong|f  ^khen|zs
soi|zs  ^^can|j  quo|ws  uo|ws  gan|w  non|w  ^khon|r  ^huon|z  ^gong|f  poi|w
^mon|j  nguo|w  ^ay|z  ^xu|wj  kha|wr  vuoi|wj  ^xoang|f  gioi|zr  ^^kin|s  trong|w
^ray|zr  ^meo|r  ^^re|x  ^^ddo|wj  ^^thieu|zr  ^^buoi|wr  ^lam|s  gim|f  ^nguu|wj  ^khang|j
^thau|j  ^^xich|s  ^pau|zs  ^cot|wj  ^uong|wr  lic|s  ^ghen|f  ^iu|r  nghem|zj  ^chuya|s
dan|wr  ^^cam|w  ^xung|wr  chuen|zj  chong|zj  ^pin|f  mieng|zx  ^^chien|zr  ^^thanh|s  tren|r
^^nguu|w  phiem|zx  thanh|zf  ^quynh|r  ^chien|zj  ^^lat|zj  ^ghet|zj  ^giang|j  chon|r  oan|w
^loang|ws  ^nhien|zx  ^ram|wj  ^bia|s  go|ws  luo|ws  luong|z  loong|r  don|wj  ^giec|s
^^khiem|zs  soong|s  ^ddiu|r  ^^nit|j  ^^tam|ws  ^^ke|zf  ^^dip|j  hin|f  ^^mien|z  ^luom|ws
^no|zs  ruch|j  ^cam|f  kiu|f  liep|zj  sien|zx  ^thoi|f  ^gom|wf  ^^bo|s  try|r
^guom|wf  ^san|wr  nien|zj  ^tuoi|zf  nhunh|wx  huu|ws  nhay|x  den|zx  ^^hum|f  ^^tho|wj
^^ngui|f  ^ngoang|j  xua|ws  ngoi|zx  nghach|s  ^^ngoi|wj  ^duong|wr  ^moi|f  ^^thau|zs  ^heu|zf
^ngiem|z  ^kech|zj  ^^dan|zs  yem|zf  ^^so|f  ut|j  ^thoat|ws  loa|r  ddan|x  ^doi|zr
^chue|z  ddieng|z  ^puoi|w  ruoc|zj  pach|j  cuong|zr  gioa|s  ^phau|zf  dda|j  ^nem|f
khoang|wr  ^lau|s  ^^than|zj  thi|x  ^^quat|zs  ^boi|r  ^^tren|x  ^siep|zj  ^phua|w  ^duong|zf
^pang|wf  ^^goi|s  ^voc|zs  xu|wf  that|j  ^huong|wx  nhinh|s  ^than|j  deu|zf  ^lau|r
phac|ws  ^^bieu|zx  ^khop|zj  ^toong|s  ^tep|zj  ^map|j  ^^bun|s  truot|zs  ^^cho|s  ^^mo|r
tic|j  ^^thoang|r  ^tro|r  huon|wx  ^phinh|r  ^^den|zf  dduenh|zr  ^cham|r  tui|f  tan|x
^uech|zs  ^coi|zf  khop|zs  truoi|zj  ^khon|f  ^um|wf  me|zx  roi|zr  xach|j  ^^day|zf
^phay|s  chen|zs  ^^nai|s  lot|wj  ^xam|r  ^xieu|zs  nom|ws  ngoet|s  luen|z  nghu|wx
khao|f  ^mieu|zr  chien|zr  quac|j  ddong|x  ^triep|zj  ^xan|s  khoi|zx  ^^lep|s  ^voi|j
ben|r  ^^khon|z  ^^ruc|wj  ^^gom|zs  ^khac|zj  ^liu|x  ^^mung|f  ua|r  ^som|zr  khuy|r
^ngen|j  ^ngang|w  xin|x  ^chep|j  ^nghiu|j  loat|ws  ^the|zx  ^dam|wf  ^^loi|z  ^khu|j
^^diu|j  toa|x  pet|zs  huo|ws  ^senh|zs  ^rom|zf  put|s  ^khang|ws  dang|r  ^hup|s
^^gam|ws  them|s  ^^tuy|s  nguen|zj  nhap|j  dop|zj  ^^rong|zf  ^^choc|j  buu|wx  tun|ws
trua|j  ^ngoao|f  ^hui|r  ^bam|z  lon|z  ^gu|s  ^than|zs  ^eo|r  trang|wj  ^hoanh|j
^^uy|s  bau|zr  ^mut|wj  ^kheo|r  ^nem|zf  ghien|zj  ^nguoi|wr  nghen|f  tanh|w  ^duyen|zj
^chuan|zj  ^dden|zj  ^^vot|ws  ^^doi|zs  ^muay|z  ^ruan|zf  ^^ne|r  ^^thuy|f  ^xet|zs  ^ddieng|zj
^quap|ws  sun|f  ^^tuu|wr  viec|zs  ^^nghien|z  ngeo|f  ^ddong|zx  nung|wf  ^^na|f  bang|x
^^khao|r  ^^ren|f  ^tam|zj  ^hic|s  nhanh|z  ^^lot|zj  ghi|r  ^tran|r  ^^nau|z  ^^nuou|ws
^^tom|z  ^^rinh|f  ruoc|wj  ^^cong|zs  ^^nem|s  ^guon|w  tham|x  ^luyt|s  ^ngiet|zj  sua|zs
vau|zx  ^^nguoi|zj  ^^tan|f  gau|zj  vua|f  dduong|ws  ^xe|f  ^sam|zj  nhun|f  ^huan|zr
pai|r  xoe|s  xuon|zs  ^khuc|j  nguoi|wx  ^^nuong|ws  ngum|r  ^^vut|ws  ^ngoai|x  ^cuom|wf
kho|wr  lau|zx  guoi|w  ^guong|wf  ^chiem|zx  ^luong|ws  mooc|j  ^con|r  ^rua|wx  ^mao|s
^^gia|x  nuyen|z  ngheng|f  ^quai|f  ang|wr  ^su|wf  viep|zj  leu|zj  ^nay|s  ^^lan|w
ddo|wr  ^phon|j  ta|wx  xung|r  ^ngau|zs  ^^cach|j  nhu|j  uych|j  ^^ngoai|r  ^huom|w
^^day|x  choam|f  ^xoi|wj  ^^chu|w  ^^kech|zj  ruong|wr  ^^gium|f  oap|s  ^^ruong|zj  ^san|zs
nan|wf  quen|zf  ^ddoanh|f  keng|f  ^sooc|j  gap|j  thop|zj  ^^dde|zs  hoe|r  ^^cop|j
gang|wj  ^chau|zr  quau|f  ^^nhieu|z  ^dom|r  ^^thu|j  ^^pho|w  ^niem|zx  kha|w  loanh|f
^mun|s  ^^on|zr  soang|s  ^^dum|f  ^khao|f  gio|zs  vuoc|zj  ^^ddo|zs  guay|z  ^^xu|ws
^^chap|j  ^ngum|j  ^poi|ws  ^dday|x  mien|zr  ^po|r  nha|zs  ^not|ws  nun|f  ^man|w
^tap|wj  ^tim|r  uu|wj  ^^ga|j  ^dat|zs  ^^nhai|s  ^miet|zs  ddua|j  ^du|r  ^noe|s
tan|zx  dda|wx  gao|x  ^xinh|f  sai|j  ^^hu|f  ^^khi|r  khong|zx  ^chong|r  thay|zx
^^nguy|j  phim|f  nguyen|zr  thua|ws  phiem|zj  ^quac|wj  ^^tuot|zj  ^^tra|s  soc|ws  ^^loan|f
^nho|wr  ^^vay|zj  ^^boi|wr  nop|wj  muom|zs  chom|zj  ^^xe|zj  tro|zj  ^ko|f  ^^ban|ws
luong|ws  ^ngon|zj  phe|zf  ^mui|j  phen|zr  ^^thien|zf  get|zs  ^^tua|wj  ^^hoi|wx  ^riu|s
^khau|s  ^^vo|zf  ^lem|f  ^pop|zs  ^san|x  chi|x  huy|x  rom|zf  miem|zj  ^^tau|zr
^xo|zf  pien|zf  ^^no|w  ^^hich|s  ^phim|f  tec|zj  ^hung|wj  ^^vuon|w  meu|zf  ^khieng|zs
^^ruot|zj  ^rem|z  gioc|zs  ^li|j  tray|f  ^^chan|w  ^huenh|z  ^^mu|j  ^^co|j  ^toac|j
tuu|wf  ^uu|wx  ^^tat|s  ^^can|ws  ^^boi|w  uyen|zs  ^^buoi|zr  ^soc|zj  vau|f  thoach|j
^giang|ws  ^^giong|zf  xe|zr  nap|s  ^xap|s  ^ruoc|wj  tran|r  ^^dan|x  ^ddem|s  ^ham|wf
^trem|z  ^khenh|z  ^chuoi|z  ^^guoc|zs  ^vung|wj  ^khu|w  kien|zx  ddon|wx  ^^trai|r  ^hoang|wx
nieng|zs  ngieu|zf  ^nhay|z  khieng|zr  ^tua|ws  ^nhoang|wf  ^kong|zf  ^do|wf  lia|s  ^dduo|wj
hung|x  rem|z  dong|r  choac|s  ^^quay|zj  ^nang|wr  ^trong|r  tung|r  ^nech|zs  ^^pham|f
^^ddon|zs  khau|zx  ^^ga|x  ^^bien|zj  rieng|zs  von|j  ^roi|zr  tuya|s  ^quan|f  nguay|z
^^khoan|r  ^sam|zx  ^liem|zj  rang|wr  ^^phi|r  ^pong|r  ^dduy|  xip|s  ^uon|w  chuom|z
^^cong|zf  gic|s  gia|z  ^nuoc|zs  ^goai|r  ^^ne|zf  ^choai|j  ^ri|j  bu|w  cham|wr
gion|s  suoi|wf  ^^hot|s  ton|ws  nam|z  ngam|s  hap|ws  an|ws  ^^nham|z  xep|zj
om|x  gion|x  ^xiem|zr  duyet|zs  ^tun|r  ^^tac|wj  ^chang|r  dduoi|wj  ga|wj  ^^nhung|s
^hon|s  lien|zj  ^voang|f  ^^sa|r  rim|j  ^^ddo|f  ^re|f  uom|z  ^^chieng|z  riec|zs
^tua|wf  ^^dinh|f  kanh|f  ^^bam|zs  ^^ngua|wr  tia|f  xang|wj  ^tuan|zj  giua|w  ^^hau|zf
^^tut|j  ^^vay|zf  ^^trui|j  ^phung|s  ^^but|ws  na|wj  ^gec|s  ang|zf  ^on|x  rot|j
ga|w  thuat|zs  nhuon|zj  ^xech|zs  ^rien|zs  ^^ham|z  ^tun|s  ^goi|w  gioi|wr  vop|ws
^^bach|s  ^^khoi|s  ^phe|j  xum|r  ^nom|wj  ^got|ws  ^kau|zj  rung|wj  ^yeu|zf  ddoai|j
enh|zj  tuyenh|zf  ay|f  ^xu|wf  tuyen|zx  nhon|z  ^reu|zf  giet|zj  ^^seo|j  ^^troc|s
^^de|zs  ^tuenh|zf  ^^chiec|zs  ddau|zx  than|j  ^than|ws  ^sua|wj  ^troi|zj  ^^lo|wf  ^tay|zf
at|zs  ^^pho|zr  ^bap|wj  dduo|wj  ^xo|zs  ^kinh|j  tang|x  ^phuong|zs  ^^con|z  de|s
^ddung|wr  ^sang|z  ^^ang|w  duoi|zr  soan|f  khau|zj  bue|z  ^puoi|z  rai|f  ^rech|s
^tro|z  ^ghec|s  ddi|j  ^^huou|w  xom|w  ^chiu|s  om|w  ^xim|s  ^^vit|j  ^^ddua|x
^huu|ws  ray|zs  ^^thuyet|zs  ^^ddoi|s  then|z  minh|j  rinh|s  ^ngoan|wf  hech|zj  tro|z
^beu|zj  ^^vat|wj  ^duc|ws  luu|ws  choanh|f  nga|ws  ^tria|r  ^^tu|j  ^kam|j  luo|wj
trang|wr  ^dop|zs  ddenh|zj  ^phot|j  ^dinh|f  ^^bon|zj  ^xin|f  ge|f  gho|zf  niem|zs
ghen|x  giay|zr  ^nhung|wf  ^cuong|zr  ^phien|zj  ap|j  ^vuong|wf  ^nieu|zj  ^muu|wr  ^^neo|r
^bieu|zx  xung|wj  muom|zf  ^khau|r  ^nieng|zs  suu|wx  ^piec|zs  ^bech|zs  xiu|j  ngam|wj
^^trung|w  ^hoi|zr  phay|j  ^^nuot|zs  ^quam|ws  buu|ws  ^trui|x  ^phong|zj  ^ung|f  ^hien|zx
^^canh|j  ^^ru|x  ^vec|s  ^^lan|f  son|z  ^ran|z  luoi|zs  ^ngum|r  ^^cuc|s  ^^khuong|w
^muoc|zs  ^dua|f  ^vo|zr  ^bang|zj  da|z  tren|zf  ^quyi|s  ^num|w  ^^giu|x  ^ddoai|s
^^nong|f  ^day|zx  hiu|j  ddun|r  ^^bui|f  tua|wr  tec|j  noan|f  ^trui|j  ^thay|r
^choi|wf  ^bin|f  ^theu|zs  ru|w  lum|r  than|wr  ^von|f  ^^ruoi|wx  ^^sap|zs  gui|wf
^^quyt|s  ^^ne|f  ^xang|j  ^rang|x  tha|j  ^huot|zs  ^^vieng|zs  rien|zf  vong|s  xon|wr
^^tach|j  ^^ddua|f  ^^so|wf  ^denh|zs  dduoi|zx  noa|f  xoong|j  ^^lau|zr  ^piet|zj  ^ung|wf
^lieng|zj  ^^tan|r  ^^bi|f  nhui|x  guyet|zj  ^^chuot|zj  ^cho|j  ^chec|zj  ^muot|zs  vay|f
^^kieng|zr  ^ton|f  ngheu|zr  khum|j  tuong|wx  may|zf  ^^mu|x  vao|x  ^^hong|r  noc|ws
^nheu|zf  ^^gian|zj  danh|r  ^^hoai|j  ca|w  ^ngan|zx  ^lap|s  ^vay|f  nhet|zj  chuan|zx
tri|r  boi|wj  ^muan|z  ^suot|wj  ^nuoc|wj  ^kanh|f  re|zj  ^^tram|r  nhu|wx  ^^hoac|wj
^chom|w  ^cang|wf  ^phy|s  ^gep|s  ^ken|r  ^ngam|w  ^phon|w  ^dden|z  bam|r  nho|wj
^khang|r  pe|j  loe|j  ^phuong|ws  ^^thinh|r  ^trieu|zr  cuc|ws  ^rac|wj  ^yeng|zr  ^^ha|x
thoi|zf  tuyep|zj  chuyet|zj  ^giua|x  duc|s  ^^nhap|s  noong|j  ^may|zr  kang|w  ddeo|j
^ua|wf  ^si|s  ^^rao|f  dung|r  ^doc|zj  thau|s  ^nhep|s  ^xom|ws  vung|ws  guyen|z
^huenh|zs  ^^ddoi|wj  ku|f  ^rap|zs  ^^ddeo|  ^^xom|s  ^nhit|s  pien|z  ^^cai|f  ^^lung|wr
^ddiem|z  ^don|f  ^giang|wr  ^phuon|ws  ^^buom|zf  ^giom|s  ^room|j  ^ddieu|f  dda|zs  kon|ws
^^khuan|zr  vac|zj  ^no|zf  tha|x  ^^bap|ws  ^nhia|f  ^^sup|s  ^quat|wj  ^ngam|wf  ^^cum|j
^dong|r  muon|zf  quanh|f  ^^ta|s  ^tret|s  sop|wj  ^ddem|zf  nam|x  ^rom|x  voa|f
^goi|f  don|s  ^pang|f  ^^tran|zs  ^moi|zj  do|zr  ^^nac|zs  gioi|x  ^^lon|zj  ^^ddai|
^^rang|w  ^tret|zj  nghinh|j  lam|s  ^cheo|r  chuyenh|zs  theo|r  ^yem|z  chu|x  ^^ddem|zj
^ranh|j  ha|zf  ^nghit|j  hoach|wj  ^^kheo|s  thy|s  ^^hue|zj  ^^can|r  ^^goi|wr  ^tieu|zj
^rung|wj  ^^tao|r  ^chec|j  chu|j  ^^vai|r  ^giam|w  doan|x  ^ddong|w  ^soi|wx  ^minh|x
^nhap|ws  ^dduon|z  ^^toai|j  ^vuu|wf  dduoi|zj  ^nung|wf  ^not|s  ^lec|s  kum|w  ^muong|zr
^^hoan|x  ^chec|s  ngun|s  xan|r  ^^choi|zr  ^^van|x  ^^ra|f  ^^chui|wr  uoi|ws  chuya|s
mim|f  ^^vinh|j  seng|s  ^mam|wj  ^^ho|z  chau|zx  ^tuoc|wj  am|ws  ^chung|wr  ^^khuyen|zr
^ddan|x  ^^khang|wr  lom|s  nguong|w  ^khan|z  ^^boc|j  poc|s  ^huoi|zs  ^^can|zr  ^^trich|s
gium|j  ^nhoi|r  trui|f  ^thia|s  ^^khieu|z  ^sieu|zr  ^^nhuy|j  toach|j  ^^rap|s  thoay|s
^phoi|f  ^chua|r  ngung|wr  nghic|j  ro|zs  nop|s  ^kem|r  ^^to|f  pooc|s  ^^si|r
^kem|j  tuo|wj  ^^xoan|w  ^^thoang|s  ^ddien|zx  ma|zr  ^hoan|r  ^khuon|w  ^gui|j  ^^bu|f
he|zr  ^^nhen|z  ^^boi|zs  ^pho|r  ^^ddan|r  ^i|r  om|f  ddiem|zx  ^ge|f  ua|j
^khap|wj  ^^gio|f  khua|r  gioi|w  ^^quay|zr  men|z  ^roang|f  ^luu|wx  got|zs  ^cheng|f
^trac|wj  ^^mong|s  ^gua|f  ^^khoai|r  khin|s  ^^ve|x  ^troi|wr  duoc|zj  ^bien|zx  tre|zr
hinh|s  ^^soi|s  ^ddum|  ^^moi|zf  ^may|r  ^^hach|s  ^^ret|zs  ^gim|f  ^han|w  cong|r
gioi|wj  ^xy|r  ^gan|wf  nhong|r  ddac|zj  ^pong|zs  nguu|wr  tia|j  chuy|j  ^^khoai|s
^^ta|r  ^rop|zs  ^^phong|zr  phen|s  chac|zj  ^lung|wx  ^^nhoi|zs  ^nun|f  khinh|s  ^^tron|wj
^am|ws  ^pen|r  ^^trach|j  uong|wx  nao|r  ^min|s  ^^be|zj  khieng|zj  kiec|zs  ^truong|zr
^^mo|zj  don|wx  nong|zx  ^^suong|w  ^^hay|x  khoang|f  giay|r  ^^nguoi|w  ha|x  ^^tan|zf
^^chap|ws  ^nho|s  ^biu|x  khac|wj  ^ddai|zj  phip|s  ^dam|f  ^^tho|r  ^^sun|s  ^chon|wf
^^ai|r  inh|r  ^^cung|r  ^^nho|ws  ^^suu|w  dam|zr  ^phiep|zs  ^luo|wj  ^^mang|x  ^ddai|r
^^roi|wf  khuay|zr  ^^hong|j  ^kheo|f  don|f  ^^xon|z  troi|wj  ^nhoi|wf  mu|wj  e|r
^^com|zs  chong|wf  tun|wf  lam|wf  ^nhat|ws  ^^au|zr  ^^ro|wx  xuan|zs  ^sem|s  ^hieng|zf
^xui|j  ^^buong|zf  giam|x  ^^nhuc|ws  ^dui|j  ^^tranh|s  xy|s  ^^ki|r  ^thoa|x  ro|wr
en|j  ^ddoc|ws  bung|wr  ^^ninh|j  oi|wr  ^dot|s  truong|wx  ^thai|j  huot|ws  ^^ban|w
^cuoi|zf  ^^xuong|w  ^khoay|s  ^^khiep|zs  la|zf  huynh|j  dech|zs  ^nia|s  ^^that|ws  o|zx
^^vet|j  seu|zj  ^^tro|w  ^^coi|zj  ^^lam|j  ^^khai|r  nghao|j  ^hum|j  thom|x  nhung|wr
reo|f  nghan|f  ^^trai|x  ^^bo|wj  ^giui|s  ^^nhoa|f  ^dduoi|w  leng|f  ^ddui|r  ^chum|j
^^nhanh|s  ^chenh|zr  ^^ddoa|  vao|r  ^thanh|z  ^phun|s  ^huy|s  duoc|ws  ^lup|s  ^nhang|f
no|x  ^khuyu|r  ^^trong|f  ^kenh|zs  ^^tung|s  xut|wj  ^thon|wf  ^^on|z  ^ddom|wf  ddet|zj
^trich|j  nuom|w  ^chiu|f  rong|x  ^hech|zs  ^^tu|wx  ^con|zs  ^ddan|wf  coa|s  muon|zr
xua|j  ^tuoi|zs  beu|zj  ^bang|wj  ^^vac|ws  ^hang|wr  ^^san|ws  phac|wj  ^phong|zx  ^khay|zs
^ddan|z  ^ngon|f  xung|f  ^^xoi|z  ^^nhun|s  ^^uc|ws  ^^xam|w  ^mop|zs  ^don|z  ^kap|s
^hoong|r  ddon|wj  ia|x  ^sot|ws  ^pap|wj  khuan|zx  ddiet|zj  tiu|f  ^kim|r  ^lay|f
^ne|f  ^^bay|z  khuc|wj  ^^ua|w  thuot|zs  sun|r  lau|r  ^bon|wj  ^chao|x  truong|z
khung|j  ^^nop|zj  ni|x  xanh|r  suyet|zj  giong|f  penh|z  kuat|zj  ^cuot|zs  ^coi|wf
vong|zr  ^^chia|f  ^ung|x  ngoeo|j  xap|ws  ^puc|s  den|f  buon|zs  ^^tuan|z  chum|r
nu|ws  tha|zs  ^nhoi|zj  ^lop|s  ^chen|x  ^ngung|wx  tuen|zs  tieng|zf  reu|zf  ^^ddoan|
^riu|x  thuong|zs  ^^hoac|ws  giam|zr  tom|r  ^ddoi|zx  ^onh|z  ^chanh|f  ^thung|x  nu|f
^pai|r  thuong|z  ^^triu|x  ^^vang|zf  hon|x  ^^nut|ws  ^^rap|j  ^^nhien|z  ^tuot|ws  muoc|zs
^khoang|wr  ^nua|wf  ^hin|f  ^xu|s  giay|zj  giao|f  ^^tat|ws  ^ong|zr  ^^tuu|wj  ^thiem|zs
hum|r  pat|zj  ^^sun|j  ^nguyen|zr  ^nheo|s  ^phoi|zf  phe|r  ^gem|z  ^nhuat|zj  bam|zj
^nhui|f  ^^ke|zr  ^tron|wj  ddoi|w  ^dda|wx  ^pho|zf  ech|zj  nua|x  ^gip|s  ^lien|zj
nganh|s  ^trang|wr  ^quoc|zj  choai|x  ^sau|f  ^^troi|zx  kai|s  ^xoac|wj  ^rau|zj  ^du|ws
^seu|z  nen|f  ^pao|r  ^tron|z  ^xay|zr  ^^com|wx  ^can|wf  nghen|z  ^^nao|x  ^xoong|s
^tro|zj  ^em|zs  ^xong|zf  ^^oi|zs  khuon|w  luy|f  vuo|wj  ^^du|f  ^^gat|zj  chom|wj
^xan|w  nuu|ws  ^^gion|f  bang|wj  ^gieng|zf  ^ngau|zr  ^^ke|x  phien|zx  ghien|zs  ^^ngon|j
^^kep|j  ^^trao|f  vuong|wx  xum|j  tang|zr  ao|z  ^gio|ws  cua|x  ^pung|r  nhao|zj
^gat|ws  ddeu|zj  ^lay|s  ^^quan|zs  nhen|z  on|f  ^^voc|s  ^nho|w  ^^tron|f  kha|zr
buong|w  ^nuc|j  ^^thua|w  ^theo|r  ^thin|s  ^trao|r  ^nhieu|zj  ^ddau|f  ^ni|x  chun|x
^^dde|f  ^nan|wf  phooc|j  moi|wx  ^am|zx  thon|f  ^^mieu|z  ^quyng|f  ^^om|z  ^via|f
^^ron|wx  ^^chau|s  mam|zs  rien|zr  nguou|wf  he|x  ^^giong|j  khoen|s  ^nghe|zx  trep|j
op|ws  ^uom|ws  ^chot|j  ^he|r  ^cang|zj  ^^ki|j  tuoi|wj  ^ru|wj  ^kuc|s  ^^xao|f
thom|s  ^^trot|zs  ^nang|x  ^^dut|ws  ^han|r  ^^nang|wr  ^voong|f  am|j  oc|wj  ^^khoan|w
tieng|zr  ^bam|wf  ^^khoang|r  thoan|r  ^ron|j  ^chut|j  ^^phinh|f  ^sia|j  ^ghech|zs  ^^gang|ws
^^vet|zs  nhung|ws  ^thu|wx  sum|w  nhe|zj  ^^ddec|s  bem|zs  ^hang|z  ^^giat|wj  kem|r
^ngoi|zx  treu|zf  ^mui|r  ^nhi|r  ^nay|j  ^^phau|zx  quop|zs  hay|zr  hen|zf  ^^hot|zs
rua|w  ^duom|z  hom|w  ^bom|r  ^xut|s  von|w  dde|j  ^mung|w  khuyet|zj  ^^cu|f
^lom|wf  doat|j  nam|wj  ^khom|z  xuon|z  ^^na|x  ^^dam|zf  ^^uan|zr  trat|zs  gian|wj
^lam|zj  ^^gat|wj  mung|wx  ^giam|ws  hi|j  ^dduong|wx  trom|f  ^^phoi|z  dan|wx  toa|s
kuan|zr  khech|zj  hieng|zs  thong|j  xuot|wj  ngang|w  ngin|f  ^^dai|j  ^ddooc|s  ong|zj
nghep|s  khoi|wf  nhon|x  hua|r  ^khom|zs  ngon|zx  ghen|j  ^kot|zs  ^^kiet|zj  ^go|zr
^^re|zr  ^^lach|s  ^^thap|zj  dung|ws  sap|wj  ran|x  tring|f  nha|j  ^tram|x  ^^bet|s
dden|zx  o|zj  chai|j  ^^no|wx  rap|zs  ^phon|f  ^chom|s  ^^beo|f  sang|j  ^^ot|ws
^^ngao|f  ngen|j  ^^tuan|zr  chuop|wj  ^hu|wf  ^dang|wr  ^chac|s  ^luan|zs  chon|wj  ^lom|wx
ang|j  ^^chu|ws  ddeng|r  ^ry|x  ^khe|zf  thung|wr  ^^nhat|j  ^^phot|ws  mum|r  nghut|s
^^cu|wx  nay|zf  ^dao|s  niem|zx  nhien|zs  vuu|w  ^^tron|w  gho|zx  ^^trien|z  ^tuya|s
^^quay|zs  ^^soan|j  ^no|x  u|wx  ^kha|f  et|zj  ^^man|w  ^^rang|j  ^^he|zf  ^^mieng|z
nge|zj  noi|wj  loa|j  ^^chem|s  ket|zj  xieng|z  ai|x  ^^ta|x  tre|j  an|wj
^pua|f  bom|zf  ^kit|j  ddue|zf  dum|r  ^rau|zr  ^ming|r  ^kun|s  xin|s  ^deo|j
^^nha|j  an|zx  ^^xeo|r  ^^bam|zr  ^bam|r  tooc|j  ^^xua|w  ^^ach|s  uyen|zf  nhuong|ws
uot|wj  ^^soi|z  ^ray|r  ^^man|j  toi|zx  ^lue|z  ^nieng|zx  xeu|z  panh|f  ^^huan|z
ngim|r  ^^hoi|s  ^sop|s  ^^riec|zj  ^tren|f  xong|f  ^om|zf  ^^thung|wf  ^chun|x  ^dua|x
quoet|j  quech|j  ^^treu|zj  ^^so|j  ^thooc|s  coang|s  xo|j  khenh|zf  quao|f  ^^voi|zj
^nac|ws  ^^thieu|zf  ia|s  nang|wr  ngoeo|x  ^ma|w  ^thuong|z  cun|r  ^gianh|s  ^^ddam|zs
^^manh|s  ^not|zj  tren|zs  chem|f  ^tro|zf  ^^nguc|wj  len|zx  ^cot|ws  ^kho|zf  ^^ran|wf
^king|s  ^^mong|zj  truc|ws  ^buoi|z  som|j  ^^lai|s  kan|j  troi|wr  ^som|wx  ^^cu|wj
^^mac|s  ^^dda|r  oanh|f  go|wj  ^^ham|s  ^duong|z  ^ci|s  ^^ngo|zs  ^ghi|j  ^que|zj
^^xam|z  ^^rieng|zf  ^^nhuan|zj  nghem|z  phan|ws  nghoeo|f  ^om|w  ^lut|wj  ^se|zs  xat|j
^ven|f  ^cac|zs  ^thon|zj  giua|wr  va|zj  khonh|z  ^chenh|zf  ^phau|x  ^tram|zs  ^^nhuong|wx
^hoi|wr  ^ngo|wj  ^xu|wx  ^^lac|ws  ^^gio|zx  ^o|j  ^^ro|z  ^^xe|zs  ^^toat|s  ^^noc|j
nghenh|zf  ngien|zj  cheo|j  ^huy|f  cui|ws  ^^hoang|wf  phenh|z  khoam|w  ^ap|ws  ^^dua|ws
cho|j  ^^ly|f  dduou|wf  ^hop|zs  ^giu|s  pop|zs  ^^truc|j  ^luu|ws  gian|zf  ^guot|zj
ghap|zj  trinh|j  ^nung|wx  ^^hoi|wj  phuyet|zs  ^^gao|f  ^hon|zr  ^soong|r  ka|j  ^booc|s
lep|j  ^sia|f  ^^kieu|z  chuong|wj  ^chem|z  ^muoi|wx  ^^dda|j  ddic|j  ^trieu|zs  ^hunh|f
day|zx  ^son|zf  ^^mo|wx  ^bau|zx  ^nhoe|f  ^riet|zs  ^chem|x  sa|ws  ^ngam|wr  ^ong|r
^dach|s  coi|zr  ^ngot|ws  ^^bom|z  ^nga|j  ngong|r  ddu|wr  ngiet|zj  anh|j  buon|zr
^^truyen|zj  non|j  ^pieng|zj  ^^sau|zs  ghin|f  ^^thet|s  thuon|z  ^^kho|z  ^peng|z  ^^rai|r
^khiu|f  meng|zs  ^nu|f  ngung|wx  ^^de|r  ^oach|j  giam|f  ^ngha|r  via|f  ^xoi|zs
ngung|ws  nuop|ws  teng|f  ^^ddanh|f  ^lao|j  ^phuoi|zs  dduon|wf  ^xiu|f  ^^gao|s  ^^bai|s
^cham|wr  hieng|z  ^^na|j  ka|s  rau|r  ^^chat|zj  thuon|w  ^^gay|zj  ^^rach|j  ^^ngat|zs
giam|wf  giao|x  ^tanh|f  nieng|z  ^quo|zj  xiep|zs  xau|zf  ^chuan|zf  cuyen|zj  ^lu|j
truan|zf  ^kiu|x  ^eng|r  ^^ddong|j  hen|s  ^bua|w  dong|zx  ^phinh|s  ^hoam|w  ^lot|wj
nhoai|x  xuyec|zj  ^nghech|zs  ^nguon|zj  ngiem|z  ^truon|w  ron|zr  ^^dday|z  ^ven|zj  kham|ws
khoi|ws  cui|wf  ^quap|wj  ^^rom|wr  nhooc|j  dduong|wx  ^tim|j  ^^re|z  ^leng|j  ^^mu|f
nhe|zf  ^chum|x  ngao|x  ^thang|x  ^nenh|z  ^^rot|ws  ^^ngac|j  ^^rac|s  ^^gieng|z  ^^duyet|zj
^sin|r  rang|r  suon|zr  toe|f  ^luoi|zf  ^^tron|j  ^^khoe|s  ^hay|r  ^rech|zs  ^nhe|zs
^^nhai|f  ^^muc|wj  ^thenh|zs  hay|zs  ^mim|s  ^^nieng|zx  ^^dieu|zf  ^^chuong|zj  xong|zf  ^gau|zx
phoa|s  ^ton|wf  ^^tong|f  ^^giot|j  ^^thang|wr  quoc|s  ^no|j  tram|wj  ^^dan|wj  nuom|wj
^^ngai|j  ^^thoai|r  ^^nom|z  heu|z  ^rieng|zs  chuyen|zx  hu|ws  ^khiem|zr  xua|r  ^ngum|wf
dduoi|w  xat|wj  ^ban|x  ^loat|s  ^tru|x  ^phan|j  thoi|wr  rinh|j  ^moi|zr  ^^ddam|zj
xay|zs  nay|j  pa|f  ^^sac|j  chom|zx  ^beu|zs  ^^ddam|z  ^^suu|wr  ddoa|f  ^^rong|zx
ngech|zj  ^hom|ws  ^vong|s  xuong|zr  ^^gian|x  ^phang|s  ^leo|j  ^vung|s  ^^chai|r  ^khoan|f
^nhon|ws  ^^dduc|s  nuoc|wj  khien|zf  muoc|ws  ^hong|f  nhim|f  ^ddo|x  ^mim|x  ^bai|r
^vay|x  ^chit|j  thuonh|w  ^^han|s  ^^ddom|w  ^de|zf  trap|zs  deu|zr  ^xen|zj  menh|zf
^^mam|ws  luoi|w  hoi|ws  ^^va|r  don|zs  qua|zj  ^^ram|wf  ^xua|wr  ^^nhi|s  pot|s
