cua|  ddong|z  tai|  nguoi|w  tu|w  bi|  cong|z  gia|  va|  trong|
ban|  cho|  viet|z  nam|  o|w  co|  khong|z  thanh|  nhan|z  ddau|z
voi|w  bao|  ve|z  quoc|z  thu|  vi|  tinh|  tien|z  truong|w  bo|z
the|z  nha|  hoa|  nhat|z  vu|  ddoi|z  nam|w  thi|  an|  noi|z
ha|  hoi|z  anh|  hang|  lam|  dde|z  nhung|w  dda|  lai|  my|
xe|  trung|  ky|  dan|z  hai|  ngay|  tang|w  sinh|  phat|  cac|
qua|  moi|w  tren|z  la|  chi|  thong|z  ddo|z  su|w  con|  hoc|
co|z  vien|z  mot|z  thuong|w  dduoc|w  trieu|z  ddai|  se|  khi|  ddinh|
ho|z  van|z  ca|  tuong|w  cao|  ty|  chuyen|z  vao|  nuoc|w  dung|
giai|  bien|z  mat|w  giam|  chinh|  phong|  quan|  san|  giao|  ra|
cau|z  thu|w  tin|  gioi|w  thuc|w  phu|  du|w  ddao|  mua|  dduong|w
may|  ddien|z  hien|z  ly|  bat|w  nu|w  to|z  nghi|  cung|  nhieu|z
chu|  te|z  hon|w  chet|z  hanh|  xuat|z  nang|w  co|w  can|z  sao|
binh|  kinh|  nghiep|z  dden|z  tro|w  ddi|  canh|  vong|  bang|w  chong|z
tra|  hinh|  quan|z  tiep|z  tre|  nguyen|z  cap|z  sang|  minh|  ket|z
sau|  so|z  nghe|z  quy|  ddiem|z  dien|z  tong|z  vang|  trai|  mang|
chien|z  yeu|z  tri|  toi|z  bat|z  le|z  ddieu|z  ddang|  tan|z  nga|
tuyen|z  ddep|  ba|  trinh|  luong|w  doanh|  so|w  thai|  song|z  tich|
toan|  hoang|  lo|z  trien|z  chua|w  thang|w  hop|w  van|w  quang|  tran|z
ong|z  benh|z  cuu|w  mat|z  sat|  khai|  lon|w  chay|  len|z  xa|
thang|  than|z  tac|  han|  phai|  ngoai|  ddat|z  cuoc|z  trang|  ddoc|z
tam|z  truoc|w  y|  hieu|z  kien|z  phap|  vo|w  huong|w  tim|  tieu|z
kiem|z  lan|z  a|  tuoi|z  ddanh|  tham|  gai|  phan|z  pham|  tap|z
bai|  viec|z  ma|  loi|w  tau|  xu|w  manh|  bay|  bo|  xay|z
long|  lua|w  phi|  ddoan|  khach|  nan|  sieu|z  tay|  phuc|  bong|
mai|  dung|w  u|  lich|  lao|  pha|  lien|z  chuc|w  thieu|z  hau|z
mo|w  tranh|  si|  du|  gay|z  thoi|w  man|  cu|w  cach|  an|z
dau|z  an|w  cai|  kho|  them|z  tao|  cho|w  quyet|z  chung|  tuc|
me|  sach|  nhiem|z  hoan|  lap|z  luc|w  em|  quyen|z  phuong|w  chau|z
thuy|  ddam|  do|  danh|  be|  lan|  nhap|z  pho|z  thiet|z  dich|
gan|z  chan|z  cam|  biet|z  ke|z  chung|w  linh|  can|  nao|  che|z
tet|z  thien|z  tuan|z  duong|w  nhu|w  ddan|  mien|z  lanh|  di|  o|z
cu|  chat|z  khau|z  thao|  tu|  khoi|w  thuoc|z  phim|  nong|  bac|
he|z  ddang|w  ngan|z  muon|z  lang|  giu|w  khung|  toi|w  moi|z  khu|
nong|z  dday|z  tay|z  hat|  cuong|w  giang|  pham|z  sai|  mau|z  luat|z
thue|z  ao|  no|z  truyen|z  ben|z  ddam|z  nen|z  khoe|  cuoi|w  that|z
bac|w  cam|z  phan|  vinh|  ten|z  thoai|  niem|z  ung|w  ddoi|w  ngoi|z
nay|  ai|  mau|  san|z  khoa|  ddem|z  ddo|  giup|  tieng|z  hiem|z
vung|  ke|  cuop|w  suc|w  sac|w  ddon|  tho|w  giua|w  gian|  khoan|
vo|z  hon|z  ninh|  phieu|z  gap|w  chieu|z  dduc|w  nguy|  ve|  nghiem|z
ngo|w  gi|  mo|z  hay|  thuat|z  huy|  tiet|z  choi|w  sung|  pho|
hoat|  am|z  lo|  dai|  nho|w  chuong|w  chuan|z  xuan|z  ddua|w  cuoi|z
bieu|z  nhac|  theo|  ddot|z  luc|  nien|z  sap|w  ddat|  cua|w  da|
kich|  ddia|  vat|z  son|w  lieu|z  gio|w  sua|w  no|w  song|  toa|
toc|z  hoach|  bau|z  ddac|w  mac|w  thay|z  ngoc|  vay|  tot|z  vuot|w
giet|z  xem|  lay|z  ti|  noi|  trao|  cay|z  kim|  loai|  kieu|z
huyen|z  hung|  tham|w  tam|  phien|z  mu|  nhi|  khien|z  thuan|z  von|z
rong|z  loi|z  ddua|  nganh|  roi|w  nhau|  goi|  trom|z  nang|z  he|
xac|  ddon|w  luu|w  xin|  thay|  lam|z  tro|  xuong|z  ung|  trang|w
bang|  truc|w  roi|z  phep|  ga|  ddat|w  ddung|w  truy|  hong|z  tuy|
mua|w  chia|  huu|w  cuc|w  yen|z  ngheo|  chon|  lau|z  ddich|  sa|
duc|  tung|  hiep|z  loat|  het|z  lu|  hut|  khanh|  tang|  xanh|
day|z  ton|z  ddong|  de|z  nhom|  the|  buon|z  san|w  cang|  gon|
nhanh|  tung|w  ngu|w  nho|  ro|  rung|w  vuc|w  khoi|  muc|w  vui|
mac|  tan|  au|z  bom|  dden|  loan|  cham|z  tuyet|z  cap|w  noi|w
ap|  ngo|z  ddoi|  dang|  duoi|w  uy|  khac|w  can|w  tac|w  chan|w
vua|w  dam|z  xet|  ta|  ban|w  xang|w  mung|w  gianh|  nuoi|z  suat|z
giay|z  keo|  thuc|  banh|  thoat|  dde|  ddung|  tat|z  nhin|  xe|z
chao|  phe|z  ddau|  vai|  vo|  ngai|  thap|z  chuc|  troi|w  nua|w
buoc|w  chiem|z  thua|w  tiem|z  thich|  nguon|z  kham|  nhay|  trong|z  chiec|z
be|z  luan|z  ngu|  boi|z  tham|z  hung|w  muc|  dduoi|z  bong|z  ngan|w
cha|  som|w  me|z  mong|  cat|w  xinh|  khoi|z  lo|w  day|  sot|z
vuong|w  ddoat|  lop|w  buc|w  hao|  uu|w  chim|  hue|z  chap|z  xuc|
trach|  ngam|w  re|  nghien|z  liet|z  chua|  thach|  doa|  hy|  bung|
khuyen|z  nghia|  toc|  sau|z  tru|  tram|w  mon|  rut|  on|z  neu|z
soc|z  cum|  keu|z  dip|  kha|  dong|  lang|w  trung|w  ddap|  ddon|z
thua|  chang|  ngam|z  hop|  nghin|  ddu|  xau|z  thac|  phao|  que|z
kho|z  tron|z  ru|  dan|  nui|  nhien|z  dao|  tho|z  thit|  sy|
gui|w  mon|z  ngan|  cuc|  tiec|z  ngon|  kem|  moi|  chat|w  luoi|w
truc|  khan|w  nhung|  lac|  thon|z  tuc|w  uong|z  khan|z  ho|  vung|w
tram|  nhuan|z  nang|  na|  nhe|  xi|  nghe|  chem|  thau|z  gop|
luot|w  goi|w  lua|  vuon|w  dinh|  quay|  sat|w  van|  sap|z  khac|
boc|z  tang|z  giong|z  nai|  mi|  tru|w  hen|  soat|  con|w  ngung|w
it|  ham|  i|  vua|  hap|z  ngap|z  goc|z  giau|  phoi|z  treo|
nhan|  cat|  ngua|w  moc|z  gao|  bach|  nhiet|z  gio|  meo|  cham|w
huan|z  duy|  nguc|w  ki|  khoang|  thoi|z  hoi|w  chau|  ham|z  lenh|z
rat|z  ghi|  thoa|  rang|  soc|  nhuong|w  buoc|z  rac|  long|z  luoc|w
chiu|  to|  ruou|w  triet|z  uoc|w  bon|z  xoa|  mui|  ddap|z  phia|
cho|z  giat|z  cuon|z  tha|  om|z  diet|z  go|z  chu|w  coi|  luyen|z
quai|  mieng|z  cot|z  ddoc|  khoc|  so|  thuyen|z  hoi|  con|z  bo|w
phut|  xuong|w  le|  cup|  ngang|  non|  tui|  xuyen|z  rieng|z  chum|
buyt|  khan|  xep|z  guong|w  lung|  hom|z  go|w  ep|  lat|z  bay|z
khuc|  khao|  cham|  coc|  tran|  nham|z  giap|  boi|w  xu|  suy|
quen|z  huyet|z  hang|w  am|  nguong|w  cang|w  mo|  bui|  loc|z  mong|z
thep|  than|  gap|z  nguoc|w  hong|  tuoi|w  ddot|w  rau|  dieu|z  tam|w
huynh|  hop|z  mach|  chup|  nem|  duyen|z  ro|w  in|  ngot|  muu|w
thung|  chot|z  mem|z  beo|  un|  ich|  khen|  su|  lot|  giac|
rao|  choi|z  mam|z  tho|  nhan|w  ro|z  quanh|  troi|z  goc|  rung|
gan|w  ruot|z  rui|  trum|  bia|  khang|w  hoai|  vay|z  giac|z  vang|w
gioi|  ket|  dut|w  phau|z  ddeu|z  ret|  gay|  chang|w  ddiep|z  doi|z
lung|w  ghe|z  say|  voi|  che|  ban|z  sanh|  xung|  duoc|w  e|
kip|  tom|z  thap|  xay|  tap|  cuong|z  luon|z  ngo|  ngao|  khieu|z
ruc|w  ay|z  oan|  giay|  khoanh|  cung|w  tram|z  min|  dua|w  quynh|
vot|w  xo|z  man|w  tron|  tom|  soi|z  khang|  mao|  nop|z  soi|
han|z  uong|w  khat|  phuoc|w  rong|  sut|  xong|  ac|  nat|  sam|w
com|w  net|  giong|  xam|z  ri|  ho|w  yet|z  do|w  bung|w  ran|w
rang|w  xao|  lui|  ddo|w  may|z  lut|  ven|  chanh|  duyet|z  suyt|
kenh|z  to|w  quen|  li|  viem|z  heo|  hu|w  khon|z  choang|  ngon|z
ghen|  cong|  xua|w  lat|  hoanh|  nhip|  ngoan|  cuoc|w  bua|w  chon|z
xom|  oc|z  nham|w  diem|z  re|z  trich|  bu|  lot|z  phat|z  giau|z
doi|w  suong|w  leo|  lap|w  xoay|  ddeo|  khuyet|z  uc|  via|  vet|z
suot|z  tau|z  xung|w  trat|z  quay|z  mat|  hua|w  ngoi|w  chuot|z  nhu|
quet|  buoi|z  nu|  muoi|z  mang|w  moc|  thoi|  trau|z  menh|z  phe|
e|z  quat|z  nhau|z  cay|  on|w  kin|  pin|  guc|  loc|  suu|w
khich|  bon|  chuoi|z  nghich|  ron|z  thinh|  gian|z  nhac|w  gan|  chac|w
nau|z  ngat|z  chuong|z  truot|w  lap|  siet|z  kiet|z  thuyet|z  doc|z  giuong|w
ddut|w  vy|  chai|  dap|z  dday|  bep|z  nuong|w  that|w  de|  xon|z
boc|  uc|w  bac|z  sot|  bun|  tum|  lam|w  ddam|w  lan|w  bot|z
eo|  rua|w  cap|  nhat|  kep|  tat|  bat|  trua|w  xach|  len|
sung|w  khoai|  at|  ceo|  diu|  khap|w  rua|  sen|  kon|  choi|
rau|z  huoc|w  go|  bin|  dat|w  lac|w  dam|  chong|  nuot|z  ganh|
khuan|z  chui|  sep|z  nhai|  nhoc|  o|  bot|w  seo|  loa|  oi|w
rach|  thiep|z  coi|z  nam|z  ghep|  hon|  hi|  buu|w  chan|  rot|w
det|z  muoi|w  ne|  hoac|w  uyen|z  dep|  nghen|  cam|w  bom|w  liem|z
son|  bich|  ddem|  rap|  lech|z  khoc|z  nhua|w  buong|z  chen|  bam|
gieng|z  mun|  dang|z  loi|  vot|  tue|z  lon|z  nuc|w  gau|z  soi|w
lit|  phuc|w  muon|w  nut|  vieng|z  man|z  nhao|  sam|z  xam|w  rap|z
khu|w  pa|  doi|  vit|  voi|z  muong|w  coi|w  lun|  ria|  thom|w
tut|  phung|  goi|z  vach|  map|z  ong|  ne|z  oanh|  xong|z  gach|
nhon|z  pu|  bua|  xit|  kong|  suc|  ruong|z  sam|  bam|z  gam|z
trac|w  mia|  tat|w  kong|z  sim|  but|  ngach|  ngay|z  kia|  khiep|z
don|  ghe|  khuon|z  nut|w  nhon|w  ren|  don|z  sap|  cat|z  bup|
u|w  chin|  luy|  gom|  xich|  rac|w  thon|  suoi|z  ngac|  vat|w
ben|  cheo|  dduc|  tro|z  set|  men|  sup|  xot|  ddup|  ranh|
huc|  hu|  khiem|z  ran|  ron|w  nhuc|  dat|  gieo|  tach|  luong|z
lu|w  met|z  tre|z  thap|w  mieu|z  vac|  hep|  hot|z  nguc|  no|
vanh|  nghet|  khoac|  soan|  ruoc|w  got|  met|  ngot|z  nhat|w  phun|
mit|  lach|  bau|  nhoi|z  ray|z  gin|  te|  bep|  khop|w  kieng|z
ni|  tuu|w  gom|z  rom|w  choc|  them|  guom|w  gat|w  rinh|  ram|z
chui|w  khuat|z  tran|w  tem|  pho|w  bap|w  nhiep|z  bit|  vac|w  ghet|
chenh|z  troi|  khoan|w  gac|  im|  kheo|  nhang|  vut|w  tuoc|w  thiem|z
neo|  sac|  thieng|z  nghinh|  chich|  phoi|w  cui|  sun|  qui|  xiec|z
chot|  noc|  giot|  rai|  tia|  coc|z  ddap|w  oai|  cia|  ap|z
giang|w  quang|w  but|w  phanh|  nghieng|z  xai|  ray|  chuoc|z  huc|w  nep|z
tuong|z  huong|z  bop|  nhen|z  mam|w  nhuc|w  lop|z  xiu|  ach|  tit|
dom|  ton|w  gang|w  nham|  xam|  hoay|  ngau|z  loay|  quyt|  khe|z
biem|z  cut|  ngoi|  khe|  com|  niu|  ua|w  ddui|  phang|w  ech|z
buoi|w  hum|  kan|  tua|w  xoi|z  gio|z  nap|  nhuom|z  ot|w  nguyet|z
khuay|z  mom|z  vet|  roi|  lum|  doc|  ngat|  top|z  ut|  nghiet|z
thuoc|w  xo|w  gen|  chut|  tuot|z  voc|  nhom|z  thoang|  sec|  khue|z
phong|z  lay|  hun|  ddac|  en|  diep|z  chep|  que|  nghenh|z  run|
dan|w  quach|  chom|z  dong|z  dim|  nem|z  nhot|z  hat|z  khep|  vun|
han|w  oi|z  phot|w  rim|  xum|  ken|z  boi|  thy|  gam|w  luon|w
khet|  treu|z  cun|  ddoa|  trut|  lim|  ruot|w  quac|w  do|z  chop|w
xat|  nguoi|z  ruoi|z  vap|z  hui|  thot|  ken|  thin|  uop|w  xan|w
tron|w  ram|w  hach|  khinh|  miet|z  yem|z  ruc|  rich|  ngong|  deo|
khuong|w  giat|w  not|z  nup|  mich|  nin|  khiet|z  xeo|  giam|z  thuo|w
nap|w  nhang|w  nan|w  lia|  ngut|  then|  gu|  xen|  kiep|z  nhuoc|w
quat|  gang|  mung|  nhon|  dam|w  gat|z  loang|  lep|  say|z  siu|
het|  xui|  xy|  suon|w  thac|w  phuot|w  muot|w  ram|  ui|  buom|w
gion|  bim|  chiet|z  tuat|z  rot|  noo|  soai|  uon|z  am|w  tot|
tuon|z  ngop|w  vong|z  chieng|z  toi|  nho|z  vuong|z  xo|  up|  ngoat|w
cuom|z  bam|w  nanh|  bu|w  nhet|  giuc|  nan|z  gam|  diec|z  nay|z
ngui|  hem|  xoi|w  buou|w  nung|  ngong|z  suoi|w  thom|  oa|  tuoc|z
teo|  nhue|z  mut|w  cau|  xuoi|z  khuya|  nen|  moon|  gun|  uom|w
soo|  gat|  hat|w  xoan|w  riet|z  uan|z  gung|w  ngun|  sui|  henh|z
se|z  chap|w  trot|  chuoc|w  sen|z  chat|  veo|  troc|  gong|z  hiu|
xoai|  nap|z  than|w  vom|  giac|w  phac|  vuot|z  doan|  ruoi|w  giun|
men|z  dduoc|z  phui|  uot|w  gie|  com|z  ddan|w  thuot|z  ddiec|z  tong|
dot|z  hit|  dui|  sin|  gom|w  tan|w  hich|  leu|z  ngat|w  lem|
tac|z  thet|  lau|  goa|  loet|  dduong|z  bip|  vut|  thoc|  xiet|z
cop|  luoc|z  xua|  king|  vooc|  non|z  trac|  liu|  bieng|z  tanh|
nom|z  nach|  nhech|z  bot|  lom|  tuyt|  miu|  lieng|z  nhep|  ang|
pheo|  pan|  rot|z  iu|  ddiu|  mut|  tray|z  thut|  ngoc|z  gui|
venh|z  vam|  nhem|  xop|z  em|z  due|z  truat|z  khuynh|  trui|  nhich|
mim|  phap|z  nac|z  khoet|  toat|  theu|z  oan|w  ngheu|z  ten|  bum|
nhot|w  chip|  mep|  xoan|  chuon|z  tua|  ret|z  nhoa|  oc|  ka|
ddom|z  nhoang|  po|z  hac|  room|  tray|  huou|w  ddun|  om|  ddan|z
kho|w  hen|z  beu|z  cop|z  sip|  ddom|  ghenh|z  xiem|z  ko|  lon|
bet|  chay|z  gien|  ot|z  hom|  gion|w  phang|  on|  vang|z  khoang|w
bap|z  muong|z  thuot|w  truong|z  thun|  dang|w  chop|z  von|  phinh|  sut|w
buc|  kham|z  op|z  thung|w  hot|w  uat|z  nieu|z  ang|w  dum|  toe|
buom|z  xoang|  dop|w  bet|z  suon|z  dom|w  phach|  nheo|  oi|  kheu|z
nom|w  gut|  xoe|  reo|  thot|w  kham|w  ron|  nop|w  nhoi|  boa|
pi|  tet|  chun|  hoo|  tep|  muop|w  mot|  gieu|z  hau|  thia|
nhim|  seu|z  ham|w  xap|z  hac|w  ngui|w  chom|  xieu|z  sum|  ddenh|z
nac|  toac|  gon|z  po|  choe|  ddut|  phot|z  quan|w  nhot|  keng|
hoc|z  pen|  chit|  buot|z  loe|  suong|z  chap|  gheo|  khat|z  meu|z
kang|  tuyp|  bing|  sua|  suyen|z  vat|  hoe|  mom|  duan|z  nac|w
nhun|  nhong|z  by|  thong|  ddoai|  voan|  nguu|w  ny|  phen|  guoc|z
din|  xoc|  thop|  lat|w  ran|z  quang|z  nit|  xot|z  hua|  xom|z
reu|z  phay|z  ia|  nau|  gong|  quet|z  tiu|  ac|w  chom|w  ngop|z
triu|  khuoc|w  rom|  au|  xien|z  chac|  xoi|  rin|  hang|z  goo|
luom|w  ngung|  toai|  ngom|w  phiem|z  thot|z  gie|z  hot|  gium|  xuoc|w
riu|  thiu|  rom|z  ddang|z  ruoc|z  khat|w  chot|w  ge|  kung|  gop|z
phon|z  khoat|  truan|z  xoc|z  toanh|  penh|  rieu|z  khau|  nhut|  oam|w
chet|  mum|  rat|  ton|  ghim|  khui|  nuc|  nua|  thiec|z  ddoong|
roc|z  ddet|  nhen|  nuom|w  nuy|  hec|  von|w  sing|  nuop|w  rem|
vau|z  po|w  nhit|  pon|z  sang|w  khieng|z  mon|w  kech|z  cot|  choc|z
uot|z  lip|  thau|  xep|  toang|  nhay|z  kai|  xue|z  duot|w  chon|w
lom|z  toet|  lom|w  ap|w  dduom|w  thoong|  thui|  pac|  ghien|z  phich|
pe|z  um|  ddom|w  vin|  phiet|z  ngac|w  ruom|w  hoang|w  biu|  ngap|
ue|z  den|z  lin|  ngang|z  buong|w  ddec|  rop|w  beng|  luyn|  rum|
uoi|w  xieng|z  net|z  ngoay|  sooc|  kun|  chech|z  moan|  ua|  ngoanh|
xia|  sit|  top|  gau|  phen|z  let|  pay|  pich|  ddieng|z  gac|z
num|  boom|  muot|z  ngoa|  buy|  trat|  xang|  phin|  dduoi|w  ren|z
him|  duo|  som|  leng|  khia|  phuy|  xoom|  dia|  hoon|  khap|z
xeng|  cot|w  nghech|z  khay|  mec|  khit|  guy|  gioc|z  nieng|z  khom|
guong|z  xuyt|  ngoe|  khenh|z  let|z  tom|w  coong|  nhac|z  ddu|w  xoong|
ko|z  eng|  mop|  nhum|  duat|z  bang|z  boong|  ddot|  xat|w  ngup|
nhut|w  pom|  nuong|z  quat|w  phay|  ting|  nhap|  ddop|w  loanh|  vu|w
nghim|  tenh|z  nghit|  rup|  got|z  ooc|  duoi|z  dua|  tren|  soang|
xoac|  tria|  xech|z  quit|  giua|  ngoam|  nhoai|  rep|z  uon|w  quoi|w
soon|  phom|  mooc|  xac|w  khuang|z  dac|w  huych|  huyn|  rop|z  lup|
dat|z  at|w  chop|  huoi|z  pieu|z  ngua|  suot|w  teu|z  ngot|w  ku|
giam|w  sop|z  tap|w  biec|z  ring|  thenh|z  liec|z  pao|  giuoc|z  trau|
ming|  ngom|  pac|w  gu|w  thuong|z  pe|  khuyu|  boo|  ddin|  hip|
vich|  thim|  rit|  nhuyen|z  thuom|z  nep|  luom|z  chach|  boe|  lut|w
khoay|  nuou|w  hoen|  nia|  bec|  viu|  trap|  yeng|z  thoat|w  pang|w
quo|w  phet|z  tec|  moo|  bon|w  khua|  ddum|  ruong|w  gon|w  inh|
hom|w  lang|z  ddit|  xup|  giu|  choai|  ddoang|  bop|z  ay|  bom|z
giut|w  khuy|  om|w  noc|z  khuech|z  gum|  tup|  quap|w  penh|z  mom|w
cuom|w  kem|z  kit|  tep|z  hin|  nhui|  ngoac|w  hia|  niet|z  mem|
nung|w  nhinh|  truoi|w  phu|w  doo|  et|z  chem|z  pia|  xan|  buon|w
sich|  xec|  truu|w  sieng|z  nhong|  ddop|z  hooc|  bop|w  nich|  oach|
khuu|w  hup|  khung|w  det|  khay|z  ngam|  giap|z  phan|w  xon|w  oet|
tret|  sem|  rap|w  nhiu|  nguay|z  truon|w  thoc|z  panh|  koi|  rut|w
loong|  huyt|  ruy|  xuc|w  gap|  tip|  nhuoc|z  ping|  dau|  queo|
ngoac|  tuom|w  khun|  chut|w  kom|  xuyet|z  ngom|z  hoat|w  roc|  cac|w
oe|  khoeo|  phum|  moong|  trap|z  xang|z  cen|  hay|z  ning|  that|
oac|w  phieng|z  not|w  xuy|  hech|z  et|  trun|  ghem|  kach|  khot|
nghiu|  nghanh|  phenh|z  kao|  goay|  chuom|w  trieng|z  giat|  nhoe|  map|
nhuy|  nhy|  chang|z  xen|z  giem|z  nhe|z  xenh|z  pun|  soong|  ce|
goon|  dot|w  nhiec|z  noong|  phung|w  tuyn|  rat|w  pheng|  phet|  tun|
vim|  nom|  triem|z  loang|w  long|w  pang|  choo|  khuot|w  riep|z  duc|w
noan|  khem|  enh|z  pong|z  dem|  ngoang|w  en|z  gem|  voa|  gioi|z
denh|z  ko|w  senh|z  kam|  bech|z  ec|  pam|w  phot|  dy|  vem|
ry|  rip|  khuong|z  phon|w  gha|  vuoc|w  oem|  hoet|  seng|  xon|
kon|z  quam|w  sat|z  hieng|z  ghiec|z  nhua|  nhop|w  geng|  den|  phiu|
gion|z  cut|w  hap|  goong|  ven|z  xac|z  bap|  khen|z  set|z  choa|
don|w  pam|  toong|  coen|  son|z  thet|z  phuoc|z  luych|  khon|  uynh|
giom|z  khiu|  ot|  khong|  cheng|  kuop|z  phoc|z  tret|z  a|z  khuoi|z
thep|z  nhoam|  non|w  nhach|  ngop|  op|  heu|z  khum|  liep|z  pot|z
lop|  choan|  nguech|z  pheu|z  poc|z  pung|  giooc|  truoi|z  vop|  ong|w
vec|  tech|z  giem|  kay|  trot|w  heng|  ngum|  poc|  phuong|  thech|z
nget|  kiu|  ci|  thoan|w  pong|  quao|  phooc|  xoam|  muom|z  sia|
coo|  choac|  thing|  goan|  not|  nim|  xoanh|  ruom|z  veng|  chuy|
choet|  ngoeo|  ruon|w  ngiep|z  ngon|w  geo|  ding|  peo|  xim|  hoam|w
pua|  roong|  ngoan|w  bem|  mup|  kuo|  xoach|  cang|z  dec|  troc|z
cui|w  hoac|  huenh|z  xut|  mu|w  at|z  nuon|  soa|  nguom|w  tuenh|z
mech|z  khuoc|z  khet|z  nguoi|  tuech|z  siem|z  duong|  poe|  ddeng|  phon|
py|  roa|  truong|  khop|z  khuyech|z  pieng|z  dac|  nhoay|  nhoong|  pooc|
tuoi|  vuc|  tic|  kum|w  koo|  pham|w  trit|  lum|w  nhoi|w  veu|z
quenh|z  ghet|z  thoan|  sop|  nhop|z  vot|z  reng|  ing|  giop|z  pau|
kum|  kenh|  boon|  oang|  khoen|  phoc|  khoo|  ching|  gioang|w  vuong|
ddop|  then|z  mam|  roe|  pai|  trang|z  pat|  peng|  khap|  gua|w
ling|  boc|w  dit|  cooc|  xip|  sech|z  vam|z  quyn|  khin|  phuu|w
phec|  riec|z  too|  cuoi|  phut|w  phat|w  mic|  dup|  buon|  duong|z
nenh|z  xau|  teng|  tuot|w  toon|  doang|  xing|  giui|  pinh|  trem|
lot|w  gim|  quau|  ngoao|  benh|  ngich|  thum|  tuya|  oat|  doom|
dun|  khoam|w  chuyet|z  ngoat|  heng|z  nguyt|  cheu|z  nhop|  ngiem|z  toay|
dut|  quin|  nheu|z  khua|w  muon|  phoc|w  khot|z  koi|w  kep|z  nginh|
nun|  choong|  cy|  pet|  nooc|  pim|  chuenh|z  trooc|  koong|  vip|
trim|  nghet|z  phuon|w  phom|z  ngenh|z  quot|w  nhoen|  kau|z  ach|w  xap|
pay|z  nhoet|  oo|  pit|  vam|w  cun|w  tong|w  ghap|z  pau|z  ru|w
miem|z  uoi|z  xoet|  xan|z  vec|z  coe|  huot|z  cuot|z  trec|  pic|
uych|  phuong|z  try|  oen|  gem|z  poom|  mun|w  tem|z  roem|  phoi|
luong|  phop|z  put|  mop|z  song|w  bun|w  kon|w  ngheng|  pang|z  trua|
quon|w  booc|  deng|  noen|  nghep|z  dding|  roo|  uyt|  ngen|  huong|
puoc|z  guo|  huom|w  pien|z  ddet|z  treng|  mip|  voong|  genh|z  pui|
phua|w  nghach|  koi|z  loen|  xom|w  ngech|z  rien|z  nghieu|z  vuu|w  hiet|z
thom|z  soe|  xun|  gup|  loon|  sep|  ghom|w  nuoi|w  pap|  huo|w
put|w  dda|w  ngheng|z  dduom|z  vap|  bec|z  hoong|  quo|  phau|  tooc|
chuech|z  puc|  poong|  buyng|  moen|  ang|z  roon|  uyn|  muo|  tun|w
dop|z  ghia|  teng|z  pon|  pet|z  pec|  ngieng|z  lec|  meng|  khim|
sot|w  ngiu|  thon|w  nge|z  chiep|z  chec|z  sum|w  ngeo|  khoac|w  poi|w
uo|w  ghanh|  nguo|w  nuoc|z  ngang|w  xunh|  ddooc|  dach|  gung|  kan|z
sien|z  luyt|  biep|z  ddach|  trem|z  xoat|  nuyp|  phoong|  cum|w  vong|w
puch|  kung|w  khom|z  ddoac|  nguon|w  nic|  khoong|  voc|z  xop|  roai|
ngi|  ghech|z  chuya|  nghen|z  ku|w  nghem|z  quac|  guot|z  ip|  rech|z
muan|z  cuong|  lac|z  kuc|w  pup|  luo|w  chuom|z  ving|  quap|  oep|
luynh|  moa|  nech|z  quac|z  tuynh|  khom|w  khun|w  viep|z  kuc|  guet|z
oap|  noa|  thuon|w  buong|  quoc|  ba|w  uong|  pong|w  meng|z  puong|z
ghin|  muou|w  pot|  cac|z  cuyen|z  xet|z  chuong|  pem|  na|w  thuong|
khac|z  thua|z  koen|  doe|  khuou|w  gip|  dap|  oc|w  chuen|z  choat|w
rue|z  goac|  queng|  pu|w  giec|z  cao|z  buot|w  khoanh|w  cha|z  cop|w
mot|w  la|z  ngeu|z  dduo|w  uoc|z  nuan|z  eng|z  muoc|z  ddieu|  pac|z
nuon|z  xoo|  thanh|z  nuu|w  ec|z  pheng|z  khuon|w  choon|  kua|w  koe|
huyep|z  rem|z  kanh|  nhunh|w  giuu|w  noe|  xot|w  vom|z  moai|  git|
suoc|w  chy|  dic|  phoa|  cem|  xem|z  nuo|w  tuen|z  thop|z  kang|w
tra|z  ngien|z  nguoc|z  thuon|z  trun|w  chuu|w  trech|z  ga|w  nghom|w  koon|
xuon|z  guoi|w  thup|  xiep|z  boan|w  lep|z  trop|  thoang|w  ngiet|z  oao|
xuong|  phech|z  quo|z  gich|  khon|w  lec|z  nga|w  phun|w  ep|z  thip|
kop|z  trenh|z  pep|  xuenh|z  uay|z  quyenh|z  ngit|  huyng|  luoi|z  kha|w
nghap|z  ma|w  luot|z  ta|w  truyet|z  giui|w  uen|z  deu|z  pop|z  nhoang|w
dop|  ge|z  nghoe|  chec|  sue|z  oom|  gho|z  kic|  phac|w  ddonh|z
zday|z  poon|  ddue|z  kha|z  ddy|  nhet|z  hap|w  nhao|z  duu|w  gioa|
cuo|  kec|  got|w  guon|w  nghang|  ddic|  nghan|  sun|w  nhap|w  hing|
pan|w  hunh|  kuan|z  ngieu|z  ruan|z  map|w  vuoi|w  phuynh|  koanh|  tuyep|z
monh|  vuy|  nguon|  luen|z  tuyenh|z  khonh|z  dduou|w  tha|z  thooc|  choay|
goai|  quech|  ddiet|z  siep|z  moe|  piec|z  ao|z  rech|  nghu|w  gho|
huon|w  ca|w  sa|w  ngim|  tec|z  tunh|  giop|  choen|  dooc|  quech|z
moay|  poem|  pua|w  ruch|  ddong|w  quyng|  ca|z  trep|  choeng|  gia|z
vau|  quoet|  ciu|  vieu|z  buoi|  boeng|  noanh|  giec|  voe|  suyn|
troa|  muay|z  tuo|w  phem|z  loac|  tanh|w  koach|  voom|  dduy|  nhang|z
doong|  choom|  suyet|z  get|  suong|  khuoi|w  hic|  get|z  gic|  phy|
kheng|  tra|w  nghing|  trot|z  qua|z  uech|z  khuc|w  nghao|  phuoi|z  ha|z
uom|z  kap|  op|w  chun|w  guyen|z  nhanh|z  ngin|  giom|  duon|z  lic|
nha|z  giung|  cin|  huot|w  coa|  loom|  dda|z  ddac|z  nguen|z  huon|z
gian|w  vop|w  sop|w  hoan|w  nguou|w  thoach|  eu|z  guyet|z  duoc|z  doem|
quop|z  va|z  ngha|  cheng|z  triep|z  toach|  ddai|z  coang|  lenh|  ddoanh|
vuom|w  pach|  nuyen|z  troe|  muoc|w  nuong|  num|w  ac|z  cha|w  kot|z
gy|  xoac|w  chong|w  nhooc|  ngoet|  trong|w  poi|z  noeng|  doch|z  loat|w
puoi|w  tuong|  dech|z  nhuat|z  kuyng|  xuot|w  dduot|w  phang|z  chen|z  nghoeo|
kuat|z  phuyet|z  nhun|w  pat|z  kan|w  piet|z  hep|z  bue|z  chuyenh|z  duom|z
soc|w  gep|  khoeng|  noc|w  tronh|  dduon|w  quyi|  nghut|  luo|  nghep|
chac|z  um|w  ddoc|w  khech|z  guay|z  bem|z  nec|  noonh|  nop|  ma|z
oon|  thoay|  kiec|z  doat|  uon|  phip|  gua|  nhia|  ghec|  sui|w
sua|z  tring|  trom|  som|z  gec|  dduenh|z  voang|  roam|  giut|  ngoang|
sang|z  phoanh|  neng|  choanh|  peng|z  onh|z  khuong|  suom|w  chuop|w  gop|w
roang|  luyet|z  dong|w  phiep|z  chue|z  ric|  xeu|z  giuong|  muy|  ngoach|
nghic|  dduon|z  ba|z  pap|w  nhuon|z  giep|  puoi|z  poi|  truot|z  xap|w
gooc|  thuonh|w  dot|  lue|z  vuoc|z  vuo|w  thoac|  hem|z  ngum|w  choam|
hoach|w  xut|w  da|z  xuyec|z  vac|z  